CTTACCGCTTCCCCGGGTGC -> TTACCGCTTCCCCGGGTGCA
GGCATGGCAATGGGTGGATC -> GCATGGCAATGGGTGGATCC
ATACAAGACCCATTATGTAA -> TACAAGACCCATTATGTAAG
GTCGTCGAGGTACACCTACT -> TCGTCGAGGTACACCTACTT
CTCTTACGGTTATGCCAAAA -> TCTTACGGTTATGCCAAAAA
GAGCTGCTCTTAATAGGCTT -> AGCTGCTCTTAATAGGCTTG
CGCTTGTTTATTTAGCCTCA -> GCTTGTTTATTTAGCCTCAA
GGATCCGGGCGATCGCGGGG -> GATCCGGGCGATCGCGGGGC
GAGACGCAACGACCTGAATC -> AGACGCAACGACCTGAATCG
TAAGAGCTCGTAGACGGCTG -> AAGAGCTCGTAGACGGCTGG
CAGAACCTAAACACCGTTCG -> AGAACCTAAACACCGTTCGG
ACGTTCACGACAGGCGCTTG -> CGTTCACGACAGGCGCTTGT
GCACGGTCGTCGAGGTACAC -> CACGGTCGTCGAGGTACACC
CCTGGCGTCCGTCCCCTTAA -> CTGGCGTCCGTCCCCTTAAC
TGAATAGGAGTGCAACGCAG -> GAATAGGAGTGCAACGCAGA
GTCTCGTCCCTTGCCCGGAA -> TCTCGTCCCTTGCCCGGAAG
CACGAGAACTCAAAGTACTA -> ACGAGAACTCAAAGTACTAC
GCTACGATAGTTTACTGGTG -> CTACGATAGTTTACTGGTGA
CAAGATATAACACCGCGTAC -> AAGATATAACACCGCGTACG
GATAGTTTACTGGTGATGTC -> ATAGTTTACTGGTGATGTCC
TAAGTATATTACCGCGTAGT -> AAGTATATTACCGCGTAGTC
GCGTAGTCGCGTTCGGCCAG -> CGTAGTCGCGTTCGGCCAGA
ACAGGACAACCTGTAAATTG -> CAGGACAACCTGTAAATTGT
CGGTTATGCCAAAAATAGAT -> GGTTATGCCAAAAATAGATG
CGGCACGAGAACTCAAAGTA -> GGCACGAGAACTCAAAGTAC
ATTCGGCGTCGTACGCGTGG -> TTCGGCGTCGTACGCGTGGT
TAGCCTAATATGATTGTAGG -> AGCCTAATATGATTGTAGGA
CGTACTCTTGCTCTTACGGT -> GTACTCTTGCTCTTACGGTT
AGACTTCAGGGGTTCGTGGA -> GACTTCAGGGGTTCGTGGAA
AGACGCAACGACCTGAATCG -> GACGCAACGACCTGAATCGT
GGTCGTCGAGGTACACCTAC -> GTCGTCGAGGTACACCTACT
CGTACCTGGGTATGAGCAAG -> GTACCTGGGTATGAGCAAGT
TGTACGAGAATGGGCATGGC -> GTACGAGAATGGGCATGGCA
TACGAGAATGGGCATGGCAA -> ACGAGAATGGGCATGGCAAT
TGCGTCAGCTTTCGGATGTA -> GCGTCAGCTTTCGGATGTAA
CCGGCACGGTCGTCGAGGTA -> CGGCACGGTCGTCGAGGTAC
TACGGTTATGCCAAAAATAG -> ACGGTTATGCCAAAAATAGA
GGCCTCCCCGTAACCGGCAC -> GCCTCCCCGTAACCGGCACG
TATCAAGATATAACACCGCG -> ATCAAGATATAACACCGCGT
TATATTACCGCGTAGTCGCG -> ATATTACCGCGTAGTCGCGT
ACTTCAGGGGTTCGTGGAAA -> CTTCAGGGGTTCGTGGAAAC
CGTTCGGCCTCCCCGTAACC -> GTTCGGCCTCCCCGTAACCG
CCCATTATGTAAGTATATTA -> CCATTATGTAAGTATATTAC
ACTTAGCGAAATACAAGACC -> CTTAGCGAAATACAAGACCC
AGAGCTCGTAGACGGCTGGT -> GAGCTCGTAGACGGCTGGTA
TAGGATTGACTCGTGTTGTG -> AGGATTGACTCGTGTTGTGA
GGCGGTTCGAGTGTAAATGT -> GCGGTTCGAGTGTAAATGTA
TGGTAATTACGGAGCACATA -> GGTAATTACGGAGCACATAA
ATTACAGGACAACCTGTAAA -> TTACAGGACAACCTGTAAAT
GCTCACTCTTCTAAACGACG -> CTCACTCTTCTAAACGACGT
GTAAATTGTCGTGCAAGCCC -> TAAATTGTCGTGCAAGCCCG
TACTACGACCGGCACGGTCG -> ACTACGACCGGCACGGTCGT
GGAAGCGGTCGTCCGGCGGT -> GAAGCGGTCGTCCGGCGGTT
AGCCTCAACTGAGACTTCAG -> GCCTCAACTGAGACTTCAGG
AAGCGGTCGTCCGGCGGTTC -> AGCGGTCGTCCGGCGGTTCG
TCGTGGAAACTGTACGAGAA -> CGTGGAAACTGTACGAGAAT
ACGGTCGTCGAGGTACACCT -> CGGTCGTCGAGGTACACCTA
CCGCTTCCCCGGGTGCAGAA -> CGCTTCCCCGGGTGCAGAAC
ATTGTCGTGCAAGCCCGTCA -> TTGTCGTGCAAGCCCGTCAG
GGAGTGCAACGCAGACTTCA -> GAGTGCAACGCAGACTTCAA
CTTCCCCGGGTGCAGAACCT -> TTCCCCGGGTGCAGAACCTA
TAAAGTCCAGTAAGTTTCCG -> AAAGTCCAGTAAGTTTCCGT
TGGTCAGTAGACCTTACCGC -> GGTCAGTAGACCTTACCGCT
TGCTCTTAATAGGCTTGCTC -> GCTCTTAATAGGCTTGCTCA
TGCAAGCCCGTCAGGCGCAA -> GCAAGCCCGTCAGGCGCAAA
ACGGCAGGATTGGTAATTAC -> CGGCAGGATTGGTAATTACG
GAGAGGATGCCGTATTTAAG -> AGAGGATGCCGTATTTAAGA
TTTCGGATGTAAGGTTCGGG -> TTCGGATGTAAGGTTCGGGT
AAAATAGATGACCGAGGTTG -> AAATAGATGACCGAGGTTGG
GTGATGTCCCATTCGTCTCG -> TGATGTCCCATTCGTCTCGT
CTTGCCCGGAAGCGGTCGTC -> TTGCCCGGAAGCGGTCGTCC
TCCCCTTAACTCGAGGGACC -> CCCCTTAACTCGAGGGACCC
GAGGTGGTGGCGTACCTGGG -> AGGTGGTGGCGTACCTGGGT
ACGTGAATGCGTCAGCTTTC -> CGTGAATGCGTCAGCTTTCG
AGTCGCGTTCGGCCAGATCG -> GTCGCGTTCGGCCAGATCGA
GCTCCTGCCATCAAGATCAA -> CTCCTGCCATCAAGATCAAT
TAATAGGCTTGCTCACTCTT -> AATAGGCTTGCTCACTCTTC
GGGTGAGTATAGACGTTCAC -> GGTGAGTATAGACGTTCACG
ATTCGTCTCGTCCCTTGCCC -> TTCGTCTCGTCCCTTGCCCG
TCGAGCTGCTCTTAATAGGC -> CGAGCTGCTCTTAATAGGCT
GACCCATTATGTAAGTATAT -> ACCCATTATGTAAGTATATT
GACTCGTGTTGTGAGAGCTG -> ACTCGTGTTGTGAGAGCTGC
GCCTAATATGATTGTAGGAT -> CCTAATATGATTGTAGGATT
CTTCGTAAGAGCTCGTAGAC -> TTCGTAAGAGCTCGTAGACG
TATTTAAGATTGTCGGGGAA -> ATTTAAGATTGTCGGGGAAT
TCAAGATCAATTACAGGACA -> CAAGATCAATTACAGGACAA
CAGGACAACCTGTAAATTGT -> AGGACAACCTGTAAATTGTC
CAATGGGTGGATCCGGGCGA -> AATGGGTGGATCCGGGCGAT
GACCTTACCGCTTCCCCGGG -> ACCTTACCGCTTCCCCGGGT
AAACGACGTACAAGGGACAG -> AACGACGTACAAGGGACAGT
CCGAGGTTGGTACTTGGGCT -> CGAGGTTGGTACTTGGGCTA
AACGCAGACTTCAACGGCAG -> ACGCAGACTTCAACGGCAGG
GTTCAGTATCAAGATATAAC -> TTCAGTATCAAGATATAACA
CTTAACTCGAGGGACCCGAG -> TTAACTCGAGGGACCCGAGG
ACTGTACGAGAATGGGCATG -> CTGTACGAGAATGGGCATGG
AGGAGTGCAACGCAGACTTC -> GGAGTGCAACGCAGACTTCA
TAAGCTCCTGCCATCAAGAT -> AAGCTCCTGCCATCAAGATC
ACGGTTATGCCAAAAATAGA -> CGGTTATGCCAAAAATAGAT
AACGACGTACAAGGGACAGT -> ACGACGTACAAGGGACAGTG
GGGCGATCGCGGGGCCCTCT -> GGCGATCGCGGGGCCCTCTA
CGTCCCTTGCCCGGAAGCGG -> GTCCCTTGCCCGGAAGCGGT
TGGCGTACCTGGGTATGAGC -> GGCGTACCTGGGTATGAGCA
GAGGGACCCGAGGTACCTCA -> AGGGACCCGAGGTACCTCAA
AGCACATAATTCGGCGTCGT -> GCACATAATTCGGCGTCGTA
GTGCTACGATAGTTTACTGG -> TGCTACGATAGTTTACTGGT
CAGTAAGTTTCCGTGACGGG -> AGTAAGTTTCCGTGACGGGT
AACTCGAGGGACCCGAGGTA -> ACTCGAGGGACCCGAGGTAC
CTCCATGGATCTACCTACGT -> TCCATGGATCTACCTACGTG
CCATCAAGATCAATTACAGG -> CATCAAGATCAATTACAGGA
GTACGCGTGGTCAGTAGACC -> TACGCGTGGTCAGTAGACCT
CGGCGGTTCGAGTGTAAATG -> GGCGGTTCGAGTGTAAATGT
CCAAAAATAGATGACCGAGG -> CAAAAATAGATGACCGAGGT
CCGTGACGGGTGAGTATAGA -> CGTGACGGGTGAGTATAGAC
TCTGCTCCATGGATCTACCT -> CTGCTCCATGGATCTACCTA
ATCGTACTCTTGCTCTTACG -> TCGTACTCTTGCTCTTACGG
GGTTCGAGTGTAAATGTAAG -> GTTCGAGTGTAAATGTAAGC
CCCCGGGTGCAGAACCTAAA -> CCCGGGTGCAGAACCTAAAC
GGGACAGTGAGACGCAACGA -> GGACAGTGAGACGCAACGAC
CTCGTCCCTTGCCCGGAAGC -> TCGTCCCTTGCCCGGAAGCG
CGGCCAGATCGAGCTGCTCT -> GGCCAGATCGAGCTGCTCTT
GCTTGCTCACTCTTCTAAAC -> CTTGCTCACTCTTCTAAACG
ACTTGGGCTATACGACCTGG -> CTTGGGCTATACGACCTGGC
CCGGGCGATCGCGGGGCCCT -> CGGGCGATCGCGGGGCCCTC
ACGTACAAGGGACAGTGAGA -> CGTACAAGGGACAGTGAGAC
AGGATTGACTCGTGTTGTGA -> GGATTGACTCGTGTTGTGAG
CCCTCTAGTGGTAATTTGGA -> CCTCTAGTGGTAATTTGGAG
ATGGGCATGGCAATGGGTGG -> TGGGCATGGCAATGGGTGGA
GTTCGTGGAAACTGTACGAG -> TTCGTGGAAACTGTACGAGA
GCGTTCGGCCAGATCGAGCT -> CGTTCGGCCAGATCGAGCTG
AATTTGGAGGTGGTGGCGTA -> ATTTGGAGGTGGTGGCGTAC
ACCTCAAGTTCAGTATCAAG -> CCTCAAGTTCAGTATCAAGA
TTAGCGAAATACAAGACCCA -> TAGCGAAATACAAGACCCAT
TTATGTAAGTATATTACCGC -> TATGTAAGTATATTACCGCG
AACTCAAAGTACTACGACCG -> ACTCAAAGTACTACGACCGG
CAGGGGTTCGTGGAAACTGT -> AGGGGTTCGTGGAAACTGTA
GTTTATTTAGCCTCAACTGA -> TTTATTTAGCCTCAACTGAG
ATGGGTGGATCCGGGCGATC -> TGGGTGGATCCGGGCGATCG
ATGGCAATGGGTGGATCCGG -> TGGCAATGGGTGGATCCGGG
GATTGTAGGATTGACTCGTG -> ATTGTAGGATTGACTCGTGT
AAGTTTCCGTGACGGGTGAG -> AGTTTCCGTGACGGGTGAGT
TATGCCAAAAATAGATGACC -> ATGCCAAAAATAGATGACCG
ACCTTACCGCTTCCCCGGGT -> CCTTACCGCTTCCCCGGGTG
TCAGTAGACCTTACCGCTTC -> CAGTAGACCTTACCGCTTCC
GGTTATGCCAAAAATAGATG -> GTTATGCCAAAAATAGATGA
TCAGGGGTTCGTGGAAACTG -> CAGGGGTTCGTGGAAACTGT
TCGGCCTCCCCGTAACCGGC -> CGGCCTCCCCGTAACCGGCA
ATTGACTCGTGTTGTGAGAG -> TTGACTCGTGTTGTGAGAGC
ATCAAGATCAATTACAGGAC -> TCAAGATCAATTACAGGACA
GGTTCGGGTGCTACGATAGT -> GTTCGGGTGCTACGATAGTT
AGGCGCTTGTTTATTTAGCC -> GGCGCTTGTTTATTTAGCCT
TAGACCTTACCGCTTCCCCG -> AGACCTTACCGCTTCCCCGG
TGATTGTAGGATTGACTCGT -> GATTGTAGGATTGACTCGTG
CACCGTTCGGCCTCCCCGTA -> ACCGTTCGGCCTCCCCGTAA
TACAGGACAACCTGTAAATT -> ACAGGACAACCTGTAAATTG
TGTAAGCTCCTGCCATCAAG -> GTAAGCTCCTGCCATCAAGA
CTACGTGAATGCGTCAGCTT -> TACGTGAATGCGTCAGCTTT
TACAAGACCCATTATGTAAG -> ACAAGACCCATTATGTAAGT
ACGGGTGAGTATAGACGTTC -> CGGGTGAGTATAGACGTTCA
AAGATTGTCGGGGAATAGCT -> AGATTGTCGGGGAATAGCTT
GTTGTGAGAGCTGCGTGAAT -> TTGTGAGAGCTGCGTGAATA
CGCGTACGCAACTTCGTAAG -> GCGTACGCAACTTCGTAAGA
TGGGCTATACGACCTGGCGT -> GGGCTATACGACCTGGCGTC
TGAATGCGTCAGCTTTCGGA -> GAATGCGTCAGCTTTCGGAT
CGTGTTGTGAGAGCTGCGTG -> GTGTTGTGAGAGCTGCGTGA
CGGCACGGTCGTCGAGGTAC -> GGCACGGTCGTCGAGGTACA
ACCTAAACACCGTTCGGCCT -> CCTAAACACCGTTCGGCCTC
TACTTGGGCTATACGACCTG -> ACTTGGGCTATACGACCTGG
TTACGGTTATGCCAAAAATA -> TACGGTTATGCCAAAAATAG
GTCCCTTGCCCGGAAGCGGT -> TCCCTTGCCCGGAAGCGGTC
TTCGGCCTCCCCGTAACCGG -> TCGGCCTCCCCGTAACCGGC
AGTGTAAATGTAAGCTCCTG -> GTGTAAATGTAAGCTCCTGC
ACTCGAGGGACCCGAGGTAC -> CTCGAGGGACCCGAGGTACC
GATGCCGTATTTAAGATTGT -> ATGCCGTATTTAAGATTGTC
CGGGTGCAGAACCTAAACAC -> GGGTGCAGAACCTAAACACC
CTGGTGATGTCCCATTCGTC -> TGGTGATGTCCCATTCGTCT
AATGGGTGGATCCGGGCGAT -> ATGGGTGGATCCGGGCGATC
CGACGTACAAGGGACAGTGA -> GACGTACAAGGGACAGTGAG
CGGAAGCGGTCGTCCGGCGG -> GGAAGCGGTCGTCCGGCGGT
AAGTTCAGTATCAAGATATA -> AGTTCAGTATCAAGATATAA
CACCGCGTACGCAACTTCGT -> ACCGCGTACGCAACTTCGTA
GCTTCCCCGGGTGCAGAACC -> CTTCCCCGGGTGCAGAACCT
GATATAACACCGCGTACGCA -> ATATAACACCGCGTACGCAA
CGTGGTCAGTAGACCTTACC -> GTGGTCAGTAGACCTTACCG
GCAACGACCTGAATCGTACT -> CAACGACCTGAATCGTACTC
AATACAAGACCCATTATGTA -> ATACAAGACCCATTATGTAA
CGTTCACGACAGGCGCTTGT -> GTTCACGACAGGCGCTTGTT
TTTATTTAGCCTCAACTGAG -> TTATTTAGCCTCAACTGAGA
TTAATAGGCTTGCTCACTCT -> TAATAGGCTTGCTCACTCTT
TGGTGGCGTACCTGGGTATG -> GGTGGCGTACCTGGGTATGA
AACTGTACGAGAATGGGCAT -> ACTGTACGAGAATGGGCATG
CAACGACCTGAATCGTACTC -> AACGACCTGAATCGTACTCT
CATAATTCGGCGTCGTACGC -> ATAATTCGGCGTCGTACGCG
TAACCGGCACGAGAACTCAA -> AACCGGCACGAGAACTCAAA
TGGTACCAAATTGTTGAAGT -> GGTACCAAATTGTTGAAGTT
TGTTGAAGTTGGAGAGGATG -> GTTGAAGTTGGAGAGGATGC
GTCAGTAGACCTTACCGCTT -> TCAGTAGACCTTACCGCTTC
CTAAACGACGTACAAGGGAC -> TAAACGACGTACAAGGGACA
GAGGTTGGTACTTGGGCTAT -> AGGTTGGTACTTGGGCTATA
ACCCATTATGTAAGTATATT -> CCCATTATGTAAGTATATTA
ATATAACACCGCGTACGCAA -> TATAACACCGCGTACGCAAC
GGATGTAAGGTTCGGGTGCT -> GATGTAAGGTTCGGGTGCTA
TTTGGAGGTGGTGGCGTACC -> TTGGAGGTGGTGGCGTACCT
GCGAAATACAAGACCCATTA -> CGAAATACAAGACCCATTAT
GAAATACAAGACCCATTATG -> AAATACAAGACCCATTATGT
CGAGAACTCAAAGTACTACG -> GAGAACTCAAAGTACTACGA
TAGGCTTGCTCACTCTTCTA -> AGGCTTGCTCACTCTTCTAA
CAACTTCGTAAGAGCTCGTA -> AACTTCGTAAGAGCTCGTAG
GTAACCGGCACGAGAACTCA -> TAACCGGCACGAGAACTCAA
GTATATTACCGCGTAGTCGC -> TATATTACCGCGTAGTCGCG
TAGGAGTGCAACGCAGACTT -> AGGAGTGCAACGCAGACTTC
GCTTGTTTATTTAGCCTCAA -> CTTGTTTATTTAGCCTCAAC
GCGGTTCGAGTGTAAATGTA -> CGGTTCGAGTGTAAATGTAA
GGACAGTGAGACGCAACGAC -> GACAGTGAGACGCAACGACC
CGGTCGTCGAGGTACACCTA -> GGTCGTCGAGGTACACCTAC
AACCTAAACACCGTTCGGCC -> ACCTAAACACCGTTCGGCCT
CGTCAGCTTTCGGATGTAAG -> GTCAGCTTTCGGATGTAAGG
CGACAGGCGCTTGTTTATTT -> GACAGGCGCTTGTTTATTTA
TAATTTGGAGGTGGTGGCGT -> AATTTGGAGGTGGTGGCGTA
CCAGTAAGTTTCCGTGACGG -> CAGTAAGTTTCCGTGACGGG
ATTACCGCGTAGTCGCGTTC -> TTACCGCGTAGTCGCGTTCG
TAATTACGGAGCACATAATT -> AATTACGGAGCACATAATTC
ACACCTACTTAGCGAAATAC -> CACCTACTTAGCGAAATACA
GTTGGTACTTGGGCTATACG -> TTGGTACTTGGGCTATACGA
GCTATACGACCTGGCGTCCG -> CTATACGACCTGGCGTCCGT
GTCCGGCGGTTCGAGTGTAA -> TCCGGCGGTTCGAGTGTAAA
TGTAAGTATATTACCGCGTA -> GTAAGTATATTACCGCGTAG
CTCTAGTGGTAATTTGGAGG -> TCTAGTGGTAATTTGGAGGT
TCAGCTTTCGGATGTAAGGT -> CAGCTTTCGGATGTAAGGTT
CAAGTTGCATCTGCTCCATG -> AAGTTGCATCTGCTCCATGG
TTCCCCGGGTGCAGAACCTA -> TCCCCGGGTGCAGAACCTAA
TGCCAAAAATAGATGACCGA -> GCCAAAAATAGATGACCGAG
CTAAACACCGTTCGGCCTCC -> TAAACACCGTTCGGCCTCCC
AAATACAAGACCCATTATGT -> AATACAAGACCCATTATGTA
CTGAATCGTACTCTTGCTCT -> TGAATCGTACTCTTGCTCTT
TCAAGATATAACACCGCGTA -> CAAGATATAACACCGCGTAC
CCCGTAACCGGCACGAGAAC -> CCGTAACCGGCACGAGAACT
GAGACTTCAGGGGTTCGTGG -> AGACTTCAGGGGTTCGTGGA
CTCACTCTTCTAAACGACGT -> TCACTCTTCTAAACGACGTA
TACGCAACTTCGTAAGAGCT -> ACGCAACTTCGTAAGAGCTC
TACCAAATTGTTGAAGTTGG -> ACCAAATTGTTGAAGTTGGA
GCGCAAATATAGCCTAATAT -> CGCAAATATAGCCTAATATG
ATTTAAGATTGTCGGGGAAT -> TTTAAGATTGTCGGGGAATA
TGACTCGTGTTGTGAGAGCT -> GACTCGTGTTGTGAGAGCTG
AGTGCAACGCAGACTTCAAC -> GTGCAACGCAGACTTCAACG
CTTCAACGGCAGGATTGGTA -> TTCAACGGCAGGATTGGTAA
AACGGCAGGATTGGTAATTA -> ACGGCAGGATTGGTAATTAC
GTAGGATTGACTCGTGTTGT -> TAGGATTGACTCGTGTTGTG
GCAAGTTGCATCTGCTCCAT -> CAAGTTGCATCTGCTCCATG
AATATAGCCTAATATGATTG -> ATATAGCCTAATATGATTGT
CGGAGCACATAATTCGGCGT -> GGAGCACATAATTCGGCGTC
CGTATTTAAGATTGTCGGGG -> GTATTTAAGATTGTCGGGGA
CGGCCTCCCCGTAACCGGCA -> GGCCTCCCCGTAACCGGCAC
TGAAGTTGGAGAGGATGCCG -> GAAGTTGGAGAGGATGCCGT
ATCTGCTCCATGGATCTACC -> TCTGCTCCATGGATCTACCT
GACCTGAATCGTACTCTTGC -> ACCTGAATCGTACTCTTGCT
ATAGCCTAATATGATTGTAG -> TAGCCTAATATGATTGTAGG
ATAGTTTACTGGTGATGTCC -> TAGTTTACTGGTGATGTCCC
CCTGCCATCAAGATCAATTA -> CTGCCATCAAGATCAATTAC
GTGCAGAACCTAAACACCGT -> TGCAGAACCTAAACACCGTT
TCAGTATCAAGATATAACAC -> CAGTATCAAGATATAACACC
TAGCGAAATACAAGACCCAT -> AGCGAAATACAAGACCCATT
AGTTCAGTATCAAGATATAA -> GTTCAGTATCAAGATATAAC
GGTCAGTAGACCTTACCGCT -> GTCAGTAGACCTTACCGCTT
ACACCGCGTACGCAACTTCG -> CACCGCGTACGCAACTTCGT
AGCTCCTGCCATCAAGATCA -> GCTCCTGCCATCAAGATCAA
CCGAGGTACCTCAAGTTCAG -> CGAGGTACCTCAAGTTCAGT
TAATATGATTGTAGGATTGA -> AATATGATTGTAGGATTGAC
GGCACGGTCGTCGAGGTACA -> GCACGGTCGTCGAGGTACAC
CAGGATTGGTAATTACGGAG -> AGGATTGGTAATTACGGAGC
AGATTGTCGGGGAATAGCTT -> GATTGTCGGGGAATAGCTTG
ATGCCGTATTTAAGATTGTC -> TGCCGTATTTAAGATTGTCG
ACGAGAATGGGCATGGCAAT -> CGAGAATGGGCATGGCAATG
GATGTAAGGTTCGGGTGCTA -> ATGTAAGGTTCGGGTGCTAC
CCGTAACCGGCACGAGAACT -> CGTAACCGGCACGAGAACTC
CAAATATAGCCTAATATGAT -> AAATATAGCCTAATATGATT
CCTTGCCCGGAAGCGGTCGT -> CTTGCCCGGAAGCGGTCGTC
TTGGTAATTACGGAGCACAT -> TGGTAATTACGGAGCACATA
GCATCTGCTCCATGGATCTA -> CATCTGCTCCATGGATCTAC
TGACGGGTGAGTATAGACGT -> GACGGGTGAGTATAGACGTT
GCTGGTACCAAATTGTTGAA -> CTGGTACCAAATTGTTGAAG
GCATGGCAATGGGTGGATCC -> CATGGCAATGGGTGGATCCG
AGGGACAGTGAGACGCAACG -> GGGACAGTGAGACGCAACGA
CTCGAGGGACCCGAGGTACC -> TCGAGGGACCCGAGGTACCT
GCGGTCGTCCGGCGGTTCGA -> CGGTCGTCCGGCGGTTCGAG
GCCTCAACTGAGACTTCAGG -> CCTCAACTGAGACTTCAGGG
CAATTACAGGACAACCTGTA -> AATTACAGGACAACCTGTAA
GACTTCAACGGCAGGATTGG -> ACTTCAACGGCAGGATTGGT
GCCCGTCAGGCGCAAATATA -> CCCGTCAGGCGCAAATATAG
TTACGGAGCACATAATTCGG -> TACGGAGCACATAATTCGGC
ACCTACTTAGCGAAATACAA -> CCTACTTAGCGAAATACAAG
CTGCTCTTAATAGGCTTGCT -> TGCTCTTAATAGGCTTGCTC
GATCAATTACAGGACAACCT -> ATCAATTACAGGACAACCTG
AGATCAATTACAGGACAACC -> GATCAATTACAGGACAACCT
ACAGGCGCTTGTTTATTTAG -> CAGGCGCTTGTTTATTTAGC
CTGCGTGAATAGGAGTGCAA -> TGCGTGAATAGGAGTGCAAC
GTCAGCTTTCGGATGTAAGG -> TCAGCTTTCGGATGTAAGGT
CCGGGTGCAGAACCTAAACA -> CGGGTGCAGAACCTAAACAC
TTGCATCTGCTCCATGGATC -> TGCATCTGCTCCATGGATCT
TTGACTCGTGTTGTGAGAGC -> TGACTCGTGTTGTGAGAGCT
ACGGAGCACATAATTCGGCG -> CGGAGCACATAATTCGGCGT
TTGGAGGTGGTGGCGTACCT -> TGGAGGTGGTGGCGTACCTG
TACGACCGGCACGGTCGTCG -> ACGACCGGCACGGTCGTCGA
ATTGTAGGATTGACTCGTGT -> TTGTAGGATTGACTCGTGTT
TAGCCTCAACTGAGACTTCA -> AGCCTCAACTGAGACTTCAG
CAGATCGAGCTGCTCTTAAT -> AGATCGAGCTGCTCTTAATA
GTACACCTACTTAGCGAAAT -> TACACCTACTTAGCGAAATA
TTGTTTATTTAGCCTCAACT -> TGTTTATTTAGCCTCAACTG
ATACGACCTGGCGTCCGTCC -> TACGACCTGGCGTCCGTCCC
TGCTCCATGGATCTACCTAC -> GCTCCATGGATCTACCTACG
TTCACGACAGGCGCTTGTTT -> TCACGACAGGCGCTTGTTTA
AGTAGACCTTACCGCTTCCC -> GTAGACCTTACCGCTTCCCC
CCGGAAGCGGTCGTCCGGCG -> CGGAAGCGGTCGTCCGGCGG
TTACAGGACAACCTGTAAAT -> TACAGGACAACCTGTAAATT
CGGGCGATCGCGGGGCCCTC -> GGGCGATCGCGGGGCCCTCT
GGCGCTTGTTTATTTAGCCT -> GCGCTTGTTTATTTAGCCTC
ACGATAGTTTACTGGTGATG -> CGATAGTTTACTGGTGATGT
CAGTGAGACGCAACGACCTG -> AGTGAGACGCAACGACCTGA
AGAACCTAAACACCGTTCGG -> GAACCTAAACACCGTTCGGC
TGATGTCCCATTCGTCTCGT -> GATGTCCCATTCGTCTCGTC
CCTGAATCGTACTCTTGCTC -> CTGAATCGTACTCTTGCTCT
AACACCGTTCGGCCTCCCCG -> ACACCGTTCGGCCTCCCCGT
AACACCGCGTACGCAACTTC -> ACACCGCGTACGCAACTTCG
ATTTAGCCTCAACTGAGACT -> TTTAGCCTCAACTGAGACTT
CTCTTAATAGGCTTGCTCAC -> TCTTAATAGGCTTGCTCACT
AATTCGGCGTCGTACGCGTG -> ATTCGGCGTCGTACGCGTGG
GACTTCAGGGGTTCGTGGAA -> ACTTCAGGGGTTCGTGGAAA
TCGGCCAGATCGAGCTGCTC -> CGGCCAGATCGAGCTGCTCT
TAGACGGCTGGTACCAAATT -> AGACGGCTGGTACCAAATTG
CTGGTACCAAATTGTTGAAG -> TGGTACCAAATTGTTGAAGT
CGTAAGAGCTCGTAGACGGC -> GTAAGAGCTCGTAGACGGCT
GTCCCATTCGTCTCGTCCCT -> TCCCATTCGTCTCGTCCCTT
CCCCGTAACCGGCACGAGAA -> CCCGTAACCGGCACGAGAAC
TACACCTACTTAGCGAAATA -> ACACCTACTTAGCGAAATAC
CAAAAATAGATGACCGAGGT -> AAAAATAGATGACCGAGGTT
CACGACAGGCGCTTGTTTAT -> ACGACAGGCGCTTGTTTATT
GTGAGTATAGACGTTCACGA -> TGAGTATAGACGTTCACGAC
ACCTGGCGTCCGTCCCCTTA -> CCTGGCGTCCGTCCCCTTAA
TATACGACCTGGCGTCCGTC -> ATACGACCTGGCGTCCGTCC
ATGAGCAAGTTGCATCTGCT -> TGAGCAAGTTGCATCTGCTC
AGATCGAGCTGCTCTTAATA -> GATCGAGCTGCTCTTAATAG
AGTGAGACGCAACGACCTGA -> GTGAGACGCAACGACCTGAA
CCCTTGCCCGGAAGCGGTCG -> CCTTGCCCGGAAGCGGTCGT
CCCGAGGTACCTCAAGTTCA -> CCGAGGTACCTCAAGTTCAG
TCTACCTACGTGAATGCGTC -> CTACCTACGTGAATGCGTCA
GTTGAAGTTGGAGAGGATGC -> TTGAAGTTGGAGAGGATGCC
GTGGAAACTGTACGAGAATG -> TGGAAACTGTACGAGAATGG
ACCTACGTGAATGCGTCAGC -> CCTACGTGAATGCGTCAGCT
AAATAGATGACCGAGGTTGG -> AATAGATGACCGAGGTTGGT
TGGCGTCCGTCCCCTTAACT -> GGCGTCCGTCCCCTTAACTC
GTACTACGACCGGCACGGTC -> TACTACGACCGGCACGGTCG
GAATCGTACTCTTGCTCTTA -> AATCGTACTCTTGCTCTTAC
GAGGTACCTCAAGTTCAGTA -> AGGTACCTCAAGTTCAGTAT
AGGATGCCGTATTTAAGATT -> GGATGCCGTATTTAAGATTG
GCTCTTAATAGGCTTGCTCA -> CTCTTAATAGGCTTGCTCAC
ACGACGTACAAGGGACAGTG -> CGACGTACAAGGGACAGTGA
ATGATTGTAGGATTGACTCG -> TGATTGTAGGATTGACTCGT
CTGAGACTTCAGGGGTTCGT -> TGAGACTTCAGGGGTTCGTG
GCAGAACCTAAACACCGTTC -> CAGAACCTAAACACCGTTCG
GAACTCAAAGTACTACGACC -> AACTCAAAGTACTACGACCG
AAGAGCTCGTAGACGGCTGG -> AGAGCTCGTAGACGGCTGGT
ACTGAGACTTCAGGGGTTCG -> CTGAGACTTCAGGGGTTCGT
ACCGGCACGAGAACTCAAAG -> CCGGCACGAGAACTCAAAGT
GAATGCGTCAGCTTTCGGAT -> AATGCGTCAGCTTTCGGATG
CTCAAGTTCAGTATCAAGAT -> TCAAGTTCAGTATCAAGATA
GGGGCCCTCTAGTGGTAATT -> GGGCCCTCTAGTGGTAATTT
TGAGACTTCAGGGGTTCGTG -> GAGACTTCAGGGGTTCGTGG
TTGTTGAAGTTGGAGAGGAT -> TGTTGAAGTTGGAGAGGATG
GCAACTTCGTAAGAGCTCGT -> CAACTTCGTAAGAGCTCGTA
GTTATGCCAAAAATAGATGA -> TTATGCCAAAAATAGATGAC
AGGTACCTCAAGTTCAGTAT -> GGTACCTCAAGTTCAGTATC
GGGCCCTCTAGTGGTAATTT -> GGCCCTCTAGTGGTAATTTG
CGCGTTCGGCCAGATCGAGC -> GCGTTCGGCCAGATCGAGCT
GGTGCAGAACCTAAACACCG -> GTGCAGAACCTAAACACCGT
AGACTTCAACGGCAGGATTG -> GACTTCAACGGCAGGATTGG
ATCGCGGGGCCCTCTAGTGG -> TCGCGGGGCCCTCTAGTGGT
ATCGAGCTGCTCTTAATAGG -> TCGAGCTGCTCTTAATAGGC
GGTTGGTACTTGGGCTATAC -> GTTGGTACTTGGGCTATACG
TAGTCGCGTTCGGCCAGATC -> AGTCGCGTTCGGCCAGATCG
CTATACGACCTGGCGTCCGT -> TATACGACCTGGCGTCCGTC
ATGGATCTACCTACGTGAAT -> TGGATCTACCTACGTGAATG
GCAACGCAGACTTCAACGGC -> CAACGCAGACTTCAACGGCA
CGCAACTTCGTAAGAGCTCG -> GCAACTTCGTAAGAGCTCGT
CGTACGCAACTTCGTAAGAG -> GTACGCAACTTCGTAAGAGC
GGCTGGTACCAAATTGTTGA -> GCTGGTACCAAATTGTTGAA
GCGTACGCAACTTCGTAAGA -> CGTACGCAACTTCGTAAGAG
GTTCGGCCTCCCCGTAACCG -> TTCGGCCTCCCCGTAACCGG
CGTGCAAGCCCGTCAGGCGC -> GTGCAAGCCCGTCAGGCGCA
TGCCGTATTTAAGATTGTCG -> GCCGTATTTAAGATTGTCGG
GCCCGGAAGCGGTCGTCCGG -> CCCGGAAGCGGTCGTCCGGC
AATAGATGACCGAGGTTGGT -> ATAGATGACCGAGGTTGGTA
AGGGGTTCGTGGAAACTGTA -> GGGGTTCGTGGAAACTGTAC
ATGACCGAGGTTGGTACTTG -> TGACCGAGGTTGGTACTTGG
CAACTGAGACTTCAGGGGTT -> AACTGAGACTTCAGGGGTTC
GTCGTCCGGCGGTTCGAGTG -> TCGTCCGGCGGTTCGAGTGT
GTGTAAATGTAAGCTCCTGC -> TGTAAATGTAAGCTCCTGCC
TTAGCCTCAACTGAGACTTC -> TAGCCTCAACTGAGACTTCA
TGACCGAGGTTGGTACTTGG -> GACCGAGGTTGGTACTTGGG
GAGAGCTGCGTGAATAGGAG -> AGAGCTGCGTGAATAGGAGT
AAGACCCATTATGTAAGTAT -> AGACCCATTATGTAAGTATA
TATAGACGTTCACGACAGGC -> ATAGACGTTCACGACAGGCG
CCTACTTAGCGAAATACAAG -> CTACTTAGCGAAATACAAGA
GTACCTGGGTATGAGCAAGT -> TACCTGGGTATGAGCAAGTT
AAGTTGCATCTGCTCCATGG -> AGTTGCATCTGCTCCATGGA
AATTGTCGTGCAAGCCCGTC -> ATTGTCGTGCAAGCCCGTCA
AGCGGTCGTCCGGCGGTTCG -> GCGGTCGTCCGGCGGTTCGA
ACGCGTGGTCAGTAGACCTT -> CGCGTGGTCAGTAGACCTTA
TAAATGTAAGCTCCTGCCAT -> AAATGTAAGCTCCTGCCATC
ATGCGTCAGCTTTCGGATGT -> TGCGTCAGCTTTCGGATGTA
TTCGTAAGAGCTCGTAGACG -> TCGTAAGAGCTCGTAGACGG
CGTTCGGCCAGATCGAGCTG -> GTTCGGCCAGATCGAGCTGC
AGCCTAATATGATTGTAGGA -> GCCTAATATGATTGTAGGAT
GCGTGGTCAGTAGACCTTAC -> CGTGGTCAGTAGACCTTACC
GGTGATGTCCCATTCGTCTC -> GTGATGTCCCATTCGTCTCG
TTAACTCGAGGGACCCGAGG -> TAACTCGAGGGACCCGAGGT
TACGATAGTTTACTGGTGAT -> ACGATAGTTTACTGGTGATG
CTCGTGTTGTGAGAGCTGCG -> TCGTGTTGTGAGAGCTGCGT
ATAGATGACCGAGGTTGGTA -> TAGATGACCGAGGTTGGTAC
AGCTGCTCTTAATAGGCTTG -> GCTGCTCTTAATAGGCTTGC
GTCCGTCCCCTTAACTCGAG -> TCCGTCCCCTTAACTCGAGG
GAGTGCAACGCAGACTTCAA -> AGTGCAACGCAGACTTCAAC
TTGTAGGATTGACTCGTGTT -> TGTAGGATTGACTCGTGTTG
CTAATATGATTGTAGGATTG -> TAATATGATTGTAGGATTGA
TCTTGCTCTTACGGTTATGC -> CTTGCTCTTACGGTTATGCC
TACGGAGCACATAATTCGGC -> ACGGAGCACATAATTCGGCG
AGGTTCGGGTGCTACGATAG -> GGTTCGGGTGCTACGATAGT
CCTTACCGCTTCCCCGGGTG -> CTTACCGCTTCCCCGGGTGC
TCAACTGAGACTTCAGGGGT -> CAACTGAGACTTCAGGGGTT
GCCAAAAATAGATGACCGAG -> CCAAAAATAGATGACCGAGG
TGCAGAACCTAAACACCGTT -> GCAGAACCTAAACACCGTTC
AGAGGATGCCGTATTTAAGA -> GAGGATGCCGTATTTAAGAT
TGTCCCATTCGTCTCGTCCC -> GTCCCATTCGTCTCGTCCCT
CACCTACTTAGCGAAATACA -> ACCTACTTAGCGAAATACAA
GATTGGTAATTACGGAGCAC -> ATTGGTAATTACGGAGCACA
GCGCTTGTTTATTTAGCCTC -> CGCTTGTTTATTTAGCCTCA
CGGGTGAGTATAGACGTTCA -> GGGTGAGTATAGACGTTCAC
CCTCCCCGTAACCGGCACGA -> CTCCCCGTAACCGGCACGAG
CCTAATATGATTGTAGGATT -> CTAATATGATTGTAGGATTG
GTCCCCTTAACTCGAGGGAC -> TCCCCTTAACTCGAGGGACC
GCTGCGTGAATAGGAGTGCA -> CTGCGTGAATAGGAGTGCAA
CAACGGCAGGATTGGTAATT -> AACGGCAGGATTGGTAATTA
TGGATCTACCTACGTGAATG -> GGATCTACCTACGTGAATGC
TTCAACGGCAGGATTGGTAA -> TCAACGGCAGGATTGGTAAT
CTCTTGCTCTTACGGTTATG -> TCTTGCTCTTACGGTTATGC
AATGTAAGCTCCTGCCATCA -> ATGTAAGCTCCTGCCATCAA
GAGAATGGGCATGGCAATGG -> AGAATGGGCATGGCAATGGG
AGTACTACGACCGGCACGGT -> GTACTACGACCGGCACGGTC
TCTTAATAGGCTTGCTCACT -> CTTAATAGGCTTGCTCACTC
TCGTGCAAGCCCGTCAGGCG -> CGTGCAAGCCCGTCAGGCGC
AAGCTCCTGCCATCAAGATC -> AGCTCCTGCCATCAAGATCA
ACCTGTAAATTGTCGTGCAA -> CCTGTAAATTGTCGTGCAAG
CCTCTAGTGGTAATTTGGAG -> CTCTAGTGGTAATTTGGAGG
GAGAACTCAAAGTACTACGA -> AGAACTCAAAGTACTACGAC
ATATTACCGCGTAGTCGCGT -> TATTACCGCGTAGTCGCGTT
CCGCGTAGTCGCGTTCGGCC -> CGCGTAGTCGCGTTCGGCCA
CGAGGGACCCGAGGTACCTC -> GAGGGACCCGAGGTACCTCA
GCACGAGAACTCAAAGTACT -> CACGAGAACTCAAAGTACTA
TTCTAAACGACGTACAAGGG -> TCTAAACGACGTACAAGGGA
TGGTGATGTCCCATTCGTCT -> GGTGATGTCCCATTCGTCTC
GTAATTTGGAGGTGGTGGCG -> TAATTTGGAGGTGGTGGCGT
AAGTACTACGACCGGCACGG -> AGTACTACGACCGGCACGGT
TCGAGGGACCCGAGGTACCT -> CGAGGGACCCGAGGTACCTC
GCGTCGTACGCGTGGTCAGT -> CGTCGTACGCGTGGTCAGTA
ACAAGACCCATTATGTAAGT -> CAAGACCCATTATGTAAGTA
CGTAACCGGCACGAGAACTC -> GTAACCGGCACGAGAACTCA
TACCGCTTCCCCGGGTGCAG -> ACCGCTTCCCCGGGTGCAGA
TGGAAACTGTACGAGAATGG -> GGAAACTGTACGAGAATGGG
CTACGACCGGCACGGTCGTC -> TACGACCGGCACGGTCGTCG
GCAAATATAGCCTAATATGA -> CAAATATAGCCTAATATGAT
GGGTGCTACGATAGTTTACT -> GGTGCTACGATAGTTTACTG
TAGTGGTAATTTGGAGGTGG -> AGTGGTAATTTGGAGGTGGT
AGTTGGAGAGGATGCCGTAT -> GTTGGAGAGGATGCCGTATT
AATTACGGAGCACATAATTC -> ATTACGGAGCACATAATTCG
AACTTCGTAAGAGCTCGTAG -> ACTTCGTAAGAGCTCGTAGA
TTTAGCCTCAACTGAGACTT -> TTAGCCTCAACTGAGACTTC
GTACGCAACTTCGTAAGAGC -> TACGCAACTTCGTAAGAGCT
AGACGTTCACGACAGGCGCT -> GACGTTCACGACAGGCGCTT
CGAGGTACCTCAAGTTCAGT -> GAGGTACCTCAAGTTCAGTA
ATAATTCGGCGTCGTACGCG -> TAATTCGGCGTCGTACGCGT
GATCTACCTACGTGAATGCG -> ATCTACCTACGTGAATGCGT
AATTGTTGAAGTTGGAGAGG -> ATTGTTGAAGTTGGAGAGGA
GTACCAAATTGTTGAAGTTG -> TACCAAATTGTTGAAGTTGG
GGCACGAGAACTCAAAGTAC -> GCACGAGAACTCAAAGTACT
CATCTGCTCCATGGATCTAC -> ATCTGCTCCATGGATCTACC
TGTTGTGAGAGCTGCGTGAA -> GTTGTGAGAGCTGCGTGAAT
GTACAAGGGACAGTGAGACG -> TACAAGGGACAGTGAGACGC
AGGTGGTGGCGTACCTGGGT -> GGTGGTGGCGTACCTGGGTA
AAGATATAACACCGCGTACG -> AGATATAACACCGCGTACGC
CGAGGTACACCTACTTAGCG -> GAGGTACACCTACTTAGCGA
CTCAAAGTACTACGACCGGC -> TCAAAGTACTACGACCGGCA
AATAGGCTTGCTCACTCTTC -> ATAGGCTTGCTCACTCTTCT
TGAATCGTACTCTTGCTCTT -> GAATCGTACTCTTGCTCTTA
TCCGTCCCCTTAACTCGAGG -> CCGTCCCCTTAACTCGAGGG
CCCCTTAACTCGAGGGACCC -> CCCTTAACTCGAGGGACCCG
TCAACGGCAGGATTGGTAAT -> CAACGGCAGGATTGGTAATT
AGCGAAATACAAGACCCATT -> GCGAAATACAAGACCCATTA
TCCCCGTAACCGGCACGAGA -> CCCCGTAACCGGCACGAGAA
AGGTACACCTACTTAGCGAA -> GGTACACCTACTTAGCGAAA
CTTAATAGGCTTGCTCACTC -> TTAATAGGCTTGCTCACTCT
GGGTTCGTGGAAACTGTACG -> GGTTCGTGGAAACTGTACGA
ACCGTTCGGCCTCCCCGTAA -> CCGTTCGGCCTCCCCGTAAC
TCGCGGGGCCCTCTAGTGGT -> CGCGGGGCCCTCTAGTGGTA
TCTAGTGGTAATTTGGAGGT -> CTAGTGGTAATTTGGAGGTG
GTTTACTGGTGATGTCCCAT -> TTTACTGGTGATGTCCCATT
TGCTCACTCTTCTAAACGAC -> GCTCACTCTTCTAAACGACG
TCGGATGTAAGGTTCGGGTG -> CGGATGTAAGGTTCGGGTGC
GTTTCCGTGACGGGTGAGTA -> TTTCCGTGACGGGTGAGTAT
CATTCGTCTCGTCCCTTGCC -> ATTCGTCTCGTCCCTTGCCC
ACCTGGGTATGAGCAAGTTG -> CCTGGGTATGAGCAAGTTGC
CGTCAGGCGCAAATATAGCC -> GTCAGGCGCAAATATAGCCT
TATTTAGCCTCAACTGAGAC -> ATTTAGCCTCAACTGAGACT
ACGCAACGACCTGAATCGTA -> CGCAACGACCTGAATCGTAC
CCTGGGTATGAGCAAGTTGC -> CTGGGTATGAGCAAGTTGCA
TTCGGATGTAAGGTTCGGGT -> TCGGATGTAAGGTTCGGGTG
ACGACAGGCGCTTGTTTATT -> CGACAGGCGCTTGTTTATTT
TCACTCTTCTAAACGACGTA -> CACTCTTCTAAACGACGTAC
GTTCGAGTGTAAATGTAAGC -> TTCGAGTGTAAATGTAAGCT
CCGCGTACGCAACTTCGTAA -> CGCGTACGCAACTTCGTAAG
TTCCGTGACGGGTGAGTATA -> TCCGTGACGGGTGAGTATAG
GAGCTCGTAGACGGCTGGTA -> AGCTCGTAGACGGCTGGTAC
CTACGATAGTTTACTGGTGA -> TACGATAGTTTACTGGTGAT
GGATTGACTCGTGTTGTGAG -> GATTGACTCGTGTTGTGAGA
ACAGTGAGACGCAACGACCT -> CAGTGAGACGCAACGACCTG
CGTCCGGCGGTTCGAGTGTA -> GTCCGGCGGTTCGAGTGTAA
TCGAGGTACACCTACTTAGC -> CGAGGTACACCTACTTAGCG
GCCCTCTAGTGGTAATTTGG -> CCCTCTAGTGGTAATTTGGA
CGGTTCGAGTGTAAATGTAA -> GGTTCGAGTGTAAATGTAAG
TGCTCTTACGGTTATGCCAA -> GCTCTTACGGTTATGCCAAA
TCTAAACGACGTACAAGGGA -> CTAAACGACGTACAAGGGAC
CGTAGACGGCTGGTACCAAA -> GTAGACGGCTGGTACCAAAT
ATATGATTGTAGGATTGACT -> TATGATTGTAGGATTGACTC
AAACTGTACGAGAATGGGCA -> AACTGTACGAGAATGGGCAT
CCTCAAGTTCAGTATCAAGA -> CTCAAGTTCAGTATCAAGAT
GTATTTAAGATTGTCGGGGA -> TATTTAAGATTGTCGGGGAA
GGTAATTTGGAGGTGGTGGC -> GTAATTTGGAGGTGGTGGCG
AAAGTACTACGACCGGCACG -> AAGTACTACGACCGGCACGG
AGACGGCTGGTACCAAATTG -> GACGGCTGGTACCAAATTGT
ACCGAGGTTGGTACTTGGGC -> CCGAGGTTGGTACTTGGGCT
GCTCTTACGGTTATGCCAAA -> CTCTTACGGTTATGCCAAAA
TCGTCTCGTCCCTTGCCCGG -> CGTCTCGTCCCTTGCCCGGA
TGTCGTGCAAGCCCGTCAGG -> GTCGTGCAAGCCCGTCAGGC
ACCGGCACGGTCGTCGAGGT -> CCGGCACGGTCGTCGAGGTA
GTATGAGCAAGTTGCATCTG -> TATGAGCAAGTTGCATCTGC
AAGATCAATTACAGGACAAC -> AGATCAATTACAGGACAACC
GAACCTAAACACCGTTCGGC -> AACCTAAACACCGTTCGGCC
GTGTTGTGAGAGCTGCGTGA -> TGTTGTGAGAGCTGCGTGAA
TCACGACAGGCGCTTGTTTA -> CACGACAGGCGCTTGTTTAT
ACGACCTGAATCGTACTCTT -> CGACCTGAATCGTACTCTTG
AACGACCTGAATCGTACTCT -> ACGACCTGAATCGTACTCTT
AAATTGTCGTGCAAGCCCGT -> AATTGTCGTGCAAGCCCGTC
GCCTCCCCGTAACCGGCACG -> CCTCCCCGTAACCGGCACGA
GTACGAGAATGGGCATGGCA -> TACGAGAATGGGCATGGCAA
GGACAACCTGTAAATTGTCG -> GACAACCTGTAAATTGTCGT
GGCGTCCGTCCCCTTAACTC -> GCGTCCGTCCCCTTAACTCG
ACGACCTGGCGTCCGTCCCC -> CGACCTGGCGTCCGTCCCCT
CTTGCTCACTCTTCTAAACG -> TTGCTCACTCTTCTAAACGA
TCGTGTTGTGAGAGCTGCGT -> CGTGTTGTGAGAGCTGCGTG
CGATAGTTTACTGGTGATGT -> GATAGTTTACTGGTGATGTC
GGTAATTACGGAGCACATAA -> GTAATTACGGAGCACATAAT
GAGGTACACCTACTTAGCGA -> AGGTACACCTACTTAGCGAA
AGACCTTACCGCTTCCCCGG -> GACCTTACCGCTTCCCCGGG
ACTGGTGATGTCCCATTCGT -> CTGGTGATGTCCCATTCGTC
CAAGATCAATTACAGGACAA -> AAGATCAATTACAGGACAAC
CGCGTGGTCAGTAGACCTTA -> GCGTGGTCAGTAGACCTTAC
CGCTTCCCCGGGTGCAGAAC -> GCTTCCCCGGGTGCAGAACC
TTTCCGTGACGGGTGAGTAT -> TTCCGTGACGGGTGAGTATA
CAACCTGTAAATTGTCGTGC -> AACCTGTAAATTGTCGTGCA
AGCCCGTCAGGCGCAAATAT -> GCCCGTCAGGCGCAAATATA
TAACACCGCGTACGCAACTT -> AACACCGCGTACGCAACTTC
GGTACCAAATTGTTGAAGTT -> GTACCAAATTGTTGAAGTTG
AATGCGTCAGCTTTCGGATG -> ATGCGTCAGCTTTCGGATGT
CGTCCGTCCCCTTAACTCGA -> GTCCGTCCCCTTAACTCGAG
TCAGGCGCAAATATAGCCTA -> CAGGCGCAAATATAGCCTAA
CATTATGTAAGTATATTACC -> ATTATGTAAGTATATTACCG
AACCTGTAAATTGTCGTGCA -> ACCTGTAAATTGTCGTGCAA
ACCGCGTAGTCGCGTTCGGC -> CCGCGTAGTCGCGTTCGGCC
GCCAGATCGAGCTGCTCTTA -> CCAGATCGAGCTGCTCTTAA
ACTCGTGTTGTGAGAGCTGC -> CTCGTGTTGTGAGAGCTGCG
GTTGCATCTGCTCCATGGAT -> TTGCATCTGCTCCATGGATC
ATGTCCCATTCGTCTCGTCC -> TGTCCCATTCGTCTCGTCCC
TGGGCATGGCAATGGGTGGA -> GGGCATGGCAATGGGTGGAT
TCGTCCCTTGCCCGGAAGCG -> CGTCCCTTGCCCGGAAGCGG
GGCCAGATCGAGCTGCTCTT -> GCCAGATCGAGCTGCTCTTA
CCCGTCAGGCGCAAATATAG -> CCGTCAGGCGCAAATATAGC
CGGCAGGATTGGTAATTACG -> GGCAGGATTGGTAATTACGG
TTGGAGAGGATGCCGTATTT -> TGGAGAGGATGCCGTATTTA
GTGCAACGCAGACTTCAACG -> TGCAACGCAGACTTCAACGG
AATCGTACTCTTGCTCTTAC -> ATCGTACTCTTGCTCTTACG
TAGTTTACTGGTGATGTCCC -> AGTTTACTGGTGATGTCCCA
ACGACCGGCACGGTCGTCGA -> CGACCGGCACGGTCGTCGAG
TTGGGCTATACGACCTGGCG -> TGGGCTATACGACCTGGCGT
TCGGCGTCGTACGCGTGGTC -> CGGCGTCGTACGCGTGGTCA
ATCAATTACAGGACAACCTG -> TCAATTACAGGACAACCTGT
AGGCGCAAATATAGCCTAAT -> GGCGCAAATATAGCCTAATA
GCCATCAAGATCAATTACAG -> CCATCAAGATCAATTACAGG
GGAGCACATAATTCGGCGTC -> GAGCACATAATTCGGCGTCG
TGGGTGGATCCGGGCGATCG -> GGGTGGATCCGGGCGATCGC
GTGAATAGGAGTGCAACGCA -> TGAATAGGAGTGCAACGCAG
GTCGCGTTCGGCCAGATCGA -> TCGCGTTCGGCCAGATCGAG
GATCGAGCTGCTCTTAATAG -> ATCGAGCTGCTCTTAATAGG
GGTACCTCAAGTTCAGTATC -> GTACCTCAAGTTCAGTATCA
TCGTACTCTTGCTCTTACGG -> CGTACTCTTGCTCTTACGGT
CTACTTAGCGAAATACAAGA -> TACTTAGCGAAATACAAGAC
CTTCTAAACGACGTACAAGG -> TTCTAAACGACGTACAAGGG
GGTGGTGGCGTACCTGGGTA -> GTGGTGGCGTACCTGGGTAT
CGTGACGGGTGAGTATAGAC -> GTGACGGGTGAGTATAGACG
GACGGCTGGTACCAAATTGT -> ACGGCTGGTACCAAATTGTT
TCCTGCCATCAAGATCAATT -> CCTGCCATCAAGATCAATTA
GCGTCAGCTTTCGGATGTAA -> CGTCAGCTTTCGGATGTAAG
CGCAACGACCTGAATCGTAC -> GCAACGACCTGAATCGTACT
TTCGAGTGTAAATGTAAGCT -> TCGAGTGTAAATGTAAGCTC
CGGGTGCTACGATAGTTTAC -> GGGTGCTACGATAGTTTACT
ATCTACCTACGTGAATGCGT -> TCTACCTACGTGAATGCGTC
ACTACGACCGGCACGGTCGT -> CTACGACCGGCACGGTCGTC
TTACCGCTTCCCCGGGTGCA -> TACCGCTTCCCCGGGTGCAG
GTGAGACGCAACGACCTGAA -> TGAGACGCAACGACCTGAAT
TATGATTGTAGGATTGACTC -> ATGATTGTAGGATTGACTCG
CGACCTGAATCGTACTCTTG -> GACCTGAATCGTACTCTTGC
AAAGTCCAGTAAGTTTCCGT -> AAGTCCAGTAAGTTTCCGTG
GACGTACAAGGGACAGTGAG -> ACGTACAAGGGACAGTGAGA
GGGCATGGCAATGGGTGGAT -> GGCATGGCAATGGGTGGATC
CCGTCAGGCGCAAATATAGC -> CGTCAGGCGCAAATATAGCC
CCGTATTTAAGATTGTCGGG -> CGTATTTAAGATTGTCGGGG
TAAACACCGTTCGGCCTCCC -> AAACACCGTTCGGCCTCCCC
TTTACTGGTGATGTCCCATT -> TTACTGGTGATGTCCCATTC
GCAGGATTGGTAATTACGGA -> CAGGATTGGTAATTACGGAG
CAAATTGTTGAAGTTGGAGA -> AAATTGTTGAAGTTGGAGAG
TAGATGACCGAGGTTGGTAC -> AGATGACCGAGGTTGGTACT
TCCCTTGCCCGGAAGCGGTC -> CCCTTGCCCGGAAGCGGTCG
GTCCAGTAAGTTTCCGTGAC -> TCCAGTAAGTTTCCGTGACG
CGAGTGTAAATGTAAGCTCC -> GAGTGTAAATGTAAGCTCCT
TACCTCAAGTTCAGTATCAA -> ACCTCAAGTTCAGTATCAAG
GGCTTGCTCACTCTTCTAAA -> GCTTGCTCACTCTTCTAAAC
TTATTTAGCCTCAACTGAGA -> TATTTAGCCTCAACTGAGAC
CAAGACCCATTATGTAAGTA -> AAGACCCATTATGTAAGTAT
TTAAGATTGTCGGGGAATAG -> TAAGATTGTCGGGGAATAGC
TTCGGCGTCGTACGCGTGGT -> TCGGCGTCGTACGCGTGGTC
ACGAGAACTCAAAGTACTAC -> CGAGAACTCAAAGTACTACG
CCCGGAAGCGGTCGTCCGGC -> CCGGAAGCGGTCGTCCGGCG
TACTCTTGCTCTTACGGTTA -> ACTCTTGCTCTTACGGTTAT
TACCTGGGTATGAGCAAGTT -> ACCTGGGTATGAGCAAGTTG
GTGGCGTACCTGGGTATGAG -> TGGCGTACCTGGGTATGAGC
CTACCTACGTGAATGCGTCA -> TACCTACGTGAATGCGTCAG
AGATGACCGAGGTTGGTACT -> GATGACCGAGGTTGGTACTT
ACTCAAAGTACTACGACCGG -> CTCAAAGTACTACGACCGGC
ACTCTTGCTCTTACGGTTAT -> CTCTTGCTCTTACGGTTATG
TGAGACGCAACGACCTGAAT -> GAGACGCAACGACCTGAATC
TTACCGCGTAGTCGCGTTCG -> TACCGCGTAGTCGCGTTCGG
ATAGACGTTCACGACAGGCG -> TAGACGTTCACGACAGGCGC
AGCTTTCGGATGTAAGGTTC -> GCTTTCGGATGTAAGGTTCG
ATTATGTAAGTATATTACCG -> TTATGTAAGTATATTACCGC
AAATATAGCCTAATATGATT -> AATATAGCCTAATATGATTG
ACCAAATTGTTGAAGTTGGA -> CCAAATTGTTGAAGTTGGAG
GTAGACGGCTGGTACCAAAT -> TAGACGGCTGGTACCAAATT
GTGGTAATTTGGAGGTGGTG -> TGGTAATTTGGAGGTGGTGG
ACGGCTGGTACCAAATTGTT -> CGGCTGGTACCAAATTGTTG
TCGTAAGAGCTCGTAGACGG -> CGTAAGAGCTCGTAGACGGC
CTTTCGGATGTAAGGTTCGG -> TTTCGGATGTAAGGTTCGGG
GTACCTCAAGTTCAGTATCA -> TACCTCAAGTTCAGTATCAA
GCTCGTAGACGGCTGGTACC -> CTCGTAGACGGCTGGTACCA
AAGGTTCGGGTGCTACGATA -> AGGTTCGGGTGCTACGATAG
TGCAACGCAGACTTCAACGG -> GCAACGCAGACTTCAACGGC
TGGGTATGAGCAAGTTGCAT -> GGGTATGAGCAAGTTGCATC
GATGACCGAGGTTGGTACTT -> ATGACCGAGGTTGGTACTTG
CCAAATTGTTGAAGTTGGAG -> CAAATTGTTGAAGTTGGAGA
AATAGGAGTGCAACGCAGAC -> ATAGGAGTGCAACGCAGACT
TCCAGTAAGTTTCCGTGACG -> CCAGTAAGTTTCCGTGACGG
TCCGGCGGTTCGAGTGTAAA -> CCGGCGGTTCGAGTGTAAAT
TCGAGTGTAAATGTAAGCTC -> CGAGTGTAAATGTAAGCTCC
TCTCGTCCCTTGCCCGGAAG -> CTCGTCCCTTGCCCGGAAGC
TACAAGGGACAGTGAGACGC -> ACAAGGGACAGTGAGACGCA
GCGTACCTGGGTATGAGCAA -> CGTACCTGGGTATGAGCAAG
CTGCCATCAAGATCAATTAC -> TGCCATCAAGATCAATTACA
GGCAGGATTGGTAATTACGG -> GCAGGATTGGTAATTACGGA
CGTCGAGGTACACCTACTTA -> GTCGAGGTACACCTACTTAG
ATTTGGAGGTGGTGGCGTAC -> TTTGGAGGTGGTGGCGTACC
TGGAGGTGGTGGCGTACCTG -> GGAGGTGGTGGCGTACCTGG
GACCGAGGTTGGTACTTGGG -> ACCGAGGTTGGTACTTGGGC
TGAGAGCTGCGTGAATAGGA -> GAGAGCTGCGTGAATAGGAG
TAATTCGGCGTCGTACGCGT -> AATTCGGCGTCGTACGCGTG
CTGTAAATTGTCGTGCAAGC -> TGTAAATTGTCGTGCAAGCC
GTAGACCTTACCGCTTCCCC -> TAGACCTTACCGCTTCCCCG
GAAGTTGGAGAGGATGCCGT -> AAGTTGGAGAGGATGCCGTA
CGTGGAAACTGTACGAGAAT -> GTGGAAACTGTACGAGAATG
AGTTTACTGGTGATGTCCCA -> GTTTACTGGTGATGTCCCAT
TGGTAATTTGGAGGTGGTGG -> GGTAATTTGGAGGTGGTGGC
AGGATTGGTAATTACGGAGC -> GGATTGGTAATTACGGAGCA
TCGCGTTCGGCCAGATCGAG -> CGCGTTCGGCCAGATCGAGC
GTCGTACGCGTGGTCAGTAG -> TCGTACGCGTGGTCAGTAGA
TCCGGGCGATCGCGGGGCCC -> CCGGGCGATCGCGGGGCCCT
ATAAAGTCCAGTAAGTTTCC -> TAAAGTCCAGTAAGTTTCCG
GATCGCGGGGCCCTCTAGTG -> ATCGCGGGGCCCTCTAGTGG
AGAACTCAAAGTACTACGAC -> GAACTCAAAGTACTACGACC
ACTTCGTAAGAGCTCGTAGA -> CTTCGTAAGAGCTCGTAGAC
TGTAAATTGTCGTGCAAGCC -> GTAAATTGTCGTGCAAGCCC
CAAAGTACTACGACCGGCAC -> AAAGTACTACGACCGGCACG
CTAGTGGTAATTTGGAGGTG -> TAGTGGTAATTTGGAGGTGG
TTCGGCCAGATCGAGCTGCT -> TCGGCCAGATCGAGCTGCTC
GGAAACTGTACGAGAATGGG -> GAAACTGTACGAGAATGGGC
GGCGATCGCGGGGCCCTCTA -> GCGATCGCGGGGCCCTCTAG
GTATCAAGATATAACACCGC -> TATCAAGATATAACACCGCG
CAGACTTCAACGGCAGGATT -> AGACTTCAACGGCAGGATTG
CCTGTAAATTGTCGTGCAAG -> CTGTAAATTGTCGTGCAAGC
GGGTATGAGCAAGTTGCATC -> GGTATGAGCAAGTTGCATCT
CTCAACTGAGACTTCAGGGG -> TCAACTGAGACTTCAGGGGT
GTAAATGTAAGCTCCTGCCA -> TAAATGTAAGCTCCTGCCAT
AAGTCCAGTAAGTTTCCGTG -> AGTCCAGTAAGTTTCCGTGA
GTGGATCCGGGCGATCGCGG -> TGGATCCGGGCGATCGCGGG
TCCCCGGGTGCAGAACCTAA -> CCCCGGGTGCAGAACCTAAA
GGTGGATCCGGGCGATCGCG -> GTGGATCCGGGCGATCGCGG
TCCCATTCGTCTCGTCCCTT -> CCCATTCGTCTCGTCCCTTG
TCGTAGACGGCTGGTACCAA -> CGTAGACGGCTGGTACCAAA
TCAAAGTACTACGACCGGCA -> CAAAGTACTACGACCGGCAC
CTTACGGTTATGCCAAAAAT -> TTACGGTTATGCCAAAAATA
CTCGTAGACGGCTGGTACCA -> TCGTAGACGGCTGGTACCAA
AATATGATTGTAGGATTGAC -> ATATGATTGTAGGATTGACT
GAATAGGAGTGCAACGCAGA -> AATAGGAGTGCAACGCAGAC
AGGACAACCTGTAAATTGTC -> GGACAACCTGTAAATTGTCG
TCCATGGATCTACCTACGTG -> CCATGGATCTACCTACGTGA
ATGTAAGCTCCTGCCATCAA -> TGTAAGCTCCTGCCATCAAG
GGAGAGGATGCCGTATTTAA -> GAGAGGATGCCGTATTTAAG
AGTTGCATCTGCTCCATGGA -> GTTGCATCTGCTCCATGGAT
CGTAGTCGCGTTCGGCCAGA -> GTAGTCGCGTTCGGCCAGAT
TTGTGAGAGCTGCGTGAATA -> TGTGAGAGCTGCGTGAATAG
CGCGGGGCCCTCTAGTGGTA -> GCGGGGCCCTCTAGTGGTAA
GACCGGCACGGTCGTCGAGG -> ACCGGCACGGTCGTCGAGGT
GCACATAATTCGGCGTCGTA -> CACATAATTCGGCGTCGTAC
GACGTTCACGACAGGCGCTT -> ACGTTCACGACAGGCGCTTG
CGGCGTCGTACGCGTGGTCA -> GGCGTCGTACGCGTGGTCAG
CAGCTTTCGGATGTAAGGTT -> AGCTTTCGGATGTAAGGTTC
CGTCCCCTTAACTCGAGGGA -> GTCCCCTTAACTCGAGGGAC
GATCCGGGCGATCGCGGGGC -> ATCCGGGCGATCGCGGGGCC
GTGAGAGCTGCGTGAATAGG -> TGAGAGCTGCGTGAATAGGA
AGTATAGACGTTCACGACAG -> GTATAGACGTTCACGACAGG
TTGGTACTTGGGCTATACGA -> TGGTACTTGGGCTATACGAC
CTTGTTTATTTAGCCTCAAC -> TTGTTTATTTAGCCTCAACT
CCTCAACTGAGACTTCAGGG -> CTCAACTGAGACTTCAGGGG
CAGTAGACCTTACCGCTTCC -> AGTAGACCTTACCGCTTCCC
CGCAAATATAGCCTAATATG -> GCAAATATAGCCTAATATGA
GACCCGAGGTACCTCAAGTT -> ACCCGAGGTACCTCAAGTTC
AGATATAACACCGCGTACGC -> GATATAACACCGCGTACGCA
ATGTAAGGTTCGGGTGCTAC -> TGTAAGGTTCGGGTGCTACG
ATATAGCCTAATATGATTGT -> TATAGCCTAATATGATTGTA
ACATAATTCGGCGTCGTACG -> CATAATTCGGCGTCGTACGC
TCAAGTTCAGTATCAAGATA -> CAAGTTCAGTATCAAGATAT
TATTACCGCGTAGTCGCGTT -> ATTACCGCGTAGTCGCGTTC
GAGCACATAATTCGGCGTCG -> AGCACATAATTCGGCGTCGT
CTGGGTATGAGCAAGTTGCA -> TGGGTATGAGCAAGTTGCAT
CAAGTTCAGTATCAAGATAT -> AAGTTCAGTATCAAGATATA
CAACGCAGACTTCAACGGCA -> AACGCAGACTTCAACGGCAG
GGTTCGTGGAAACTGTACGA -> GTTCGTGGAAACTGTACGAG
GAAGCGGTCGTCCGGCGGTT -> AAGCGGTCGTCCGGCGGTTC
TAACTCGAGGGACCCGAGGT -> AACTCGAGGGACCCGAGGTA
TTCAGTATCAAGATATAACA -> TCAGTATCAAGATATAACAC
TTCGTGGAAACTGTACGAGA -> TCGTGGAAACTGTACGAGAA
GAGTATAGACGTTCACGACA -> AGTATAGACGTTCACGACAG
ATCCGGGCGATCGCGGGGCC -> TCCGGGCGATCGCGGGGCCC
TGCATCTGCTCCATGGATCT -> GCATCTGCTCCATGGATCTA
CCCGGGTGCAGAACCTAAAC -> CCGGGTGCAGAACCTAAACA
GTAAGTTTCCGTGACGGGTG -> TAAGTTTCCGTGACGGGTGA
CTTGGGCTATACGACCTGGC -> TTGGGCTATACGACCTGGCG
ATAGGAGTGCAACGCAGACT -> TAGGAGTGCAACGCAGACTT
GCAATGGGTGGATCCGGGCG -> CAATGGGTGGATCCGGGCGA
GCCGTATTTAAGATTGTCGG -> CCGTATTTAAGATTGTCGGG
TTCGGGTGCTACGATAGTTT -> TCGGGTGCTACGATAGTTTA
TTGCTCTTACGGTTATGCCA -> TGCTCTTACGGTTATGCCAA
CGTACGCGTGGTCAGTAGAC -> GTACGCGTGGTCAGTAGACC
GGCAATGGGTGGATCCGGGC -> GCAATGGGTGGATCCGGGCG
CACATAATTCGGCGTCGTAC -> ACATAATTCGGCGTCGTACG
ATTGTTGAAGTTGGAGAGGA -> TTGTTGAAGTTGGAGAGGAT
GATGTCCCATTCGTCTCGTC -> ATGTCCCATTCGTCTCGTCC
TGTAGGATTGACTCGTGTTG -> GTAGGATTGACTCGTGTTGT
TAAGGTTCGGGTGCTACGAT -> AAGGTTCGGGTGCTACGATA
CTGCTCCATGGATCTACCTA -> TGCTCCATGGATCTACCTAC
CCGGCACGAGAACTCAAAGT -> CGGCACGAGAACTCAAAGTA
ATTGGTAATTACGGAGCACA -> TTGGTAATTACGGAGCACAT
GGAGGTGGTGGCGTACCTGG -> GAGGTGGTGGCGTACCTGGG
GCGTGAATAGGAGTGCAACG -> CGTGAATAGGAGTGCAACGC
TAAGTTTCCGTGACGGGTGA -> AAGTTTCCGTGACGGGTGAG
TGCTACGATAGTTTACTGGT -> GCTACGATAGTTTACTGGTG
GGGTGGATCCGGGCGATCGC -> GGTGGATCCGGGCGATCGCG
GCAGACTTCAACGGCAGGAT -> CAGACTTCAACGGCAGGATT
GACGCAACGACCTGAATCGT -> ACGCAACGACCTGAATCGTA
ACCGCGTACGCAACTTCGTA -> CCGCGTACGCAACTTCGTAA
GACGGGTGAGTATAGACGTT -> ACGGGTGAGTATAGACGTTC
CGTCTCGTCCCTTGCCCGGA -> GTCTCGTCCCTTGCCCGGAA
GGCGTCGTACGCGTGGTCAG -> GCGTCGTACGCGTGGTCAGT
ATAACACCGCGTACGCAACT -> TAACACCGCGTACGCAACTT
TACTGGTGATGTCCCATTCG -> ACTGGTGATGTCCCATTCGT
TTTAAGATTGTCGGGGAATA -> TTAAGATTGTCGGGGAATAG
GATTGTCGGGGAATAGCTTG -> ATTGTCGGGGAATAGCTTGT
GGGGTTCGTGGAAACTGTAC -> GGGTTCGTGGAAACTGTACG
TATAACACCGCGTACGCAAC -> ATAACACCGCGTACGCAACT
CTCCTGCCATCAAGATCAAT -> TCCTGCCATCAAGATCAATT
AGAATGGGCATGGCAATGGG -> GAATGGGCATGGCAATGGGT
AGGGACCCGAGGTACCTCAA -> GGGACCCGAGGTACCTCAAG
ATGCCAAAAATAGATGACCG -> TGCCAAAAATAGATGACCGA
GTATAGACGTTCACGACAGG -> TATAGACGTTCACGACAGGC
ACAAGGGACAGTGAGACGCA -> CAAGGGACAGTGAGACGCAA
GCTTTCGGATGTAAGGTTCG -> CTTTCGGATGTAAGGTTCGG
CACGGTCGTCGAGGTACACC -> ACGGTCGTCGAGGTACACCT
CCTTAACTCGAGGGACCCGA -> CTTAACTCGAGGGACCCGAG
AGTGGTAATTTGGAGGTGGT -> GTGGTAATTTGGAGGTGGTG
CAGGCGCAAATATAGCCTAA -> AGGCGCAAATATAGCCTAAT
CTTAGCGAAATACAAGACCC -> TTAGCGAAATACAAGACCCA
GTACTCTTGCTCTTACGGTT -> TACTCTTGCTCTTACGGTTA
CCTAAACACCGTTCGGCCTC -> CTAAACACCGTTCGGCCTCC
TCGTCGAGGTACACCTACTT -> CGTCGAGGTACACCTACTTA
GACAGTGAGACGCAACGACC -> ACAGTGAGACGCAACGACCT
ATTACGGAGCACATAATTCG -> TTACGGAGCACATAATTCGG
AGTATATTACCGCGTAGTCG -> GTATATTACCGCGTAGTCGC
TTGCTCACTCTTCTAAACGA -> TGCTCACTCTTCTAAACGAC
GGATGCCGTATTTAAGATTG -> GATGCCGTATTTAAGATTGT
GCAAGCCCGTCAGGCGCAAA -> CAAGCCCGTCAGGCGCAAAT
CCAGATCGAGCTGCTCTTAA -> CAGATCGAGCTGCTCTTAAT
AATGGGCATGGCAATGGGTG -> ATGGGCATGGCAATGGGTGG
GTGACGGGTGAGTATAGACG -> TGACGGGTGAGTATAGACGT
CGACCTGGCGTCCGTCCCCT -> GACCTGGCGTCCGTCCCCTT
GCTGCTCTTAATAGGCTTGC -> CTGCTCTTAATAGGCTTGCT
AGCTCGTAGACGGCTGGTAC -> GCTCGTAGACGGCTGGTACC
GTCGAGGTACACCTACTTAG -> TCGAGGTACACCTACTTAGC
AGGTTGGTACTTGGGCTATA -> GGTTGGTACTTGGGCTATAC
CATGGCAATGGGTGGATCCG -> ATGGCAATGGGTGGATCCGG
AAAAATAGATGACCGAGGTT -> AAAATAGATGACCGAGGTTG
CTGTACGAGAATGGGCATGG -> TGTACGAGAATGGGCATGGC
GTTCGGGTGCTACGATAGTT -> TTCGGGTGCTACGATAGTTT
CGAAATACAAGACCCATTAT -> GAAATACAAGACCCATTATG
GTGGTGGCGTACCTGGGTAT -> TGGTGGCGTACCTGGGTATG
ACTCTTCTAAACGACGTACA -> CTCTTCTAAACGACGTACAA
GGTGAGTATAGACGTTCACG -> GTGAGTATAGACGTTCACGA
TGCCATCAAGATCAATTACA -> GCCATCAAGATCAATTACAG
TGTAAATGTAAGCTCCTGCC -> GTAAATGTAAGCTCCTGCCA
AGTCCAGTAAGTTTCCGTGA -> GTCCAGTAAGTTTCCGTGAC
CACTCTTCTAAACGACGTAC -> ACTCTTCTAAACGACGTACA
CGCGTAGTCGCGTTCGGCCA -> GCGTAGTCGCGTTCGGCCAG
GACAGGCGCTTGTTTATTTA -> ACAGGCGCTTGTTTATTTAG
GGGCTATACGACCTGGCGTC -> GGCTATACGACCTGGCGTCC
GAGTGTAAATGTAAGCTCCT -> AGTGTAAATGTAAGCTCCTG
TAGACGTTCACGACAGGCGC -> AGACGTTCACGACAGGCGCT
GTTCACGACAGGCGCTTGTT -> TTCACGACAGGCGCTTGTTT
TTACTGGTGATGTCCCATTC -> TACTGGTGATGTCCCATTCG
GGGTGCAGAACCTAAACACC -> GGTGCAGAACCTAAACACCG
GGTCGTCCGGCGGTTCGAGT -> GTCGTCCGGCGGTTCGAGTG
GTAGTCGCGTTCGGCCAGAT -> TAGTCGCGTTCGGCCAGATC
GTGAATGCGTCAGCTTTCGG -> TGAATGCGTCAGCTTTCGGA
AGCAAGTTGCATCTGCTCCA -> GCAAGTTGCATCTGCTCCAT
TACTTAGCGAAATACAAGAC -> ACTTAGCGAAATACAAGACC
GTAAGGTTCGGGTGCTACGA -> TAAGGTTCGGGTGCTACGAT
TTGAAGTTGGAGAGGATGCC -> TGAAGTTGGAGAGGATGCCG
TCTTCTAAACGACGTACAAG -> CTTCTAAACGACGTACAAGG
AGTAAGTTTCCGTGACGGGT -> GTAAGTTTCCGTGACGGGTG
CGTCGTACGCGTGGTCAGTA -> GTCGTACGCGTGGTCAGTAG
TCAATTACAGGACAACCTGT -> CAATTACAGGACAACCTGTA
TTATGCCAAAAATAGATGAC -> TATGCCAAAAATAGATGACC
CAAGGGACAGTGAGACGCAA -> AAGGGACAGTGAGACGCAAC
TCGTCCGGCGGTTCGAGTGT -> CGTCCGGCGGTTCGAGTGTA
GTAAGCTCCTGCCATCAAGA -> TAAGCTCCTGCCATCAAGAT
GTAATTACGGAGCACATAAT -> TAATTACGGAGCACATAATT
GTAAGAGCTCGTAGACGGCT -> TAAGAGCTCGTAGACGGCTG
CCCTTAACTCGAGGGACCCG -> CCTTAACTCGAGGGACCCGA
GAAACTGTACGAGAATGGGC -> AAACTGTACGAGAATGGGCA
GGTGCTACGATAGTTTACTG -> GTGCTACGATAGTTTACTGG
ATCAAGATATAACACCGCGT -> TCAAGATATAACACCGCGTA
CCGGCGGTTCGAGTGTAAAT -> CGGCGGTTCGAGTGTAAATG
TCCGTGACGGGTGAGTATAG -> CCGTGACGGGTGAGTATAGA
GGCGCAAATATAGCCTAATA -> GCGCAAATATAGCCTAATAT
TGCCCGGAAGCGGTCGTCCG -> GCCCGGAAGCGGTCGTCCGG
CGAGGTTGGTACTTGGGCTA -> GAGGTTGGTACTTGGGCTAT
CTTGCTCTTACGGTTATGCC -> TTGCTCTTACGGTTATGCCA
CGCAGACTTCAACGGCAGGA -> GCAGACTTCAACGGCAGGAT
TTGCCCGGAAGCGGTCGTCC -> TGCCCGGAAGCGGTCGTCCG
AAACACCGTTCGGCCTCCCC -> AACACCGTTCGGCCTCCCCG
TGAGTATAGACGTTCACGAC -> GAGTATAGACGTTCACGACA
ACCCGAGGTACCTCAAGTTC -> CCCGAGGTACCTCAAGTTCA
TGAGCAAGTTGCATCTGCTC -> GAGCAAGTTGCATCTGCTCC
GGCGTACCTGGGTATGAGCA -> GCGTACCTGGGTATGAGCAA
GGTACTTGGGCTATACGACC -> GTACTTGGGCTATACGACCT
GGATCTACCTACGTGAATGC -> GATCTACCTACGTGAATGCG
CGATCGCGGGGCCCTCTAGT -> GATCGCGGGGCCCTCTAGTG
ACAACCTGTAAATTGTCGTG -> CAACCTGTAAATTGTCGTGC
TATGAGCAAGTTGCATCTGC -> ATGAGCAAGTTGCATCTGCT
GGATTGGTAATTACGGAGCA -> GATTGGTAATTACGGAGCAC
TTCGTCTCGTCCCTTGCCCG -> TCGTCTCGTCCCTTGCCCGG
GCGTCCGTCCCCTTAACTCG -> CGTCCGTCCCCTTAACTCGA
TACGACCTGGCGTCCGTCCC -> ACGACCTGGCGTCCGTCCCC
GGACCCGAGGTACCTCAAGT -> GACCCGAGGTACCTCAAGTT
AGTTTCCGTGACGGGTGAGT -> GTTTCCGTGACGGGTGAGTA
CGGTCGTCCGGCGGTTCGAG -> GGTCGTCCGGCGGTTCGAGT
CGTGAATAGGAGTGCAACGC -> GTGAATAGGAGTGCAACGCA
AACTGAGACTTCAGGGGTTC -> ACTGAGACTTCAGGGGTTCG
GGTACACCTACTTAGCGAAA -> GTACACCTACTTAGCGAAAT
AAGTTGGAGAGGATGCCGTA -> AGTTGGAGAGGATGCCGTAT
CCCATTCGTCTCGTCCCTTG -> CCATTCGTCTCGTCCCTTGC
GTACTTGGGCTATACGACCT -> TACTTGGGCTATACGACCTG
CGGGGCCCTCTAGTGGTAAT -> GGGGCCCTCTAGTGGTAATT
TACGCGTGGTCAGTAGACCT -> ACGCGTGGTCAGTAGACCTT
CTCTTCTAAACGACGTACAA -> TCTTCTAAACGACGTACAAG
TGGATCCGGGCGATCGCGGG -> GGATCCGGGCGATCGCGGGG
CTGGCGTCCGTCCCCTTAAC -> TGGCGTCCGTCCCCTTAACT
CTCCCCGTAACCGGCACGAG -> TCCCCGTAACCGGCACGAGA
GAGGATGCCGTATTTAAGAT -> AGGATGCCGTATTTAAGATT
ACTTCAACGGCAGGATTGGT -> CTTCAACGGCAGGATTGGTA
AAGCCCGTCAGGCGCAAATA -> AGCCCGTCAGGCGCAAATAT
GCTCCATGGATCTACCTACG -> CTCCATGGATCTACCTACGT
CAAGCCCGTCAGGCGCAAAT -> AAGCCCGTCAGGCGCAAATA
AGCTGCGTGAATAGGAGTGC -> GCTGCGTGAATAGGAGTGCA
GCGGGGCCCTCTAGTGGTAA -> CGGGGCCCTCTAGTGGTAAT
ACGCAACTTCGTAAGAGCTC -> CGCAACTTCGTAAGAGCTCG
AAGGGACAGTGAGACGCAAC -> AGGGACAGTGAGACGCAACG
CCATTCGTCTCGTCCCTTGC -> CATTCGTCTCGTCCCTTGCC
GACCTGGCGTCCGTCCCCTT -> ACCTGGCGTCCGTCCCCTTA
GAATGGGCATGGCAATGGGT -> AATGGGCATGGCAATGGGTG
GAGCAAGTTGCATCTGCTCC -> AGCAAGTTGCATCTGCTCCA
CCATTATGTAAGTATATTAC -> CATTATGTAAGTATATTACC
CCTACGTGAATGCGTCAGCT -> CTACGTGAATGCGTCAGCTT
ACGCAGACTTCAACGGCAGG -> CGCAGACTTCAACGGCAGGA
GTGCAAGCCCGTCAGGCGCA -> TGCAAGCCCGTCAGGCGCAA
ATAGGCTTGCTCACTCTTCT -> TAGGCTTGCTCACTCTTCTA
CGAGCTGCTCTTAATAGGCT -> GAGCTGCTCTTAATAGGCTT
AAATTGTTGAAGTTGGAGAG -> AATTGTTGAAGTTGGAGAGG
AGACCCATTATGTAAGTATA -> GACCCATTATGTAAGTATAT
CGGATGTAAGGTTCGGGTGC -> GGATGTAAGGTTCGGGTGCT
CCATGGATCTACCTACGTGA -> CATGGATCTACCTACGTGAA
TGGAGAGGATGCCGTATTTA -> GGAGAGGATGCCGTATTTAA
CTTCAGGGGTTCGTGGAAAC -> TTCAGGGGTTCGTGGAAACT
TTCAGGGGTTCGTGGAAACT -> TCAGGGGTTCGTGGAAACTG
CGTACAAGGGACAGTGAGAC -> GTACAAGGGACAGTGAGACG
TAAACGACGTACAAGGGACA -> AAACGACGTACAAGGGACAG
CCGTCCCCTTAACTCGAGGG -> CGTCCCCTTAACTCGAGGGA
GTCGTGCAAGCCCGTCAGGC -> TCGTGCAAGCCCGTCAGGCG
GGCCCTCTAGTGGTAATTTG -> GCCCTCTAGTGGTAATTTGG
AAGTATATTACCGCGTAGTC -> AGTATATTACCGCGTAGTCG
TCGGGTGCTACGATAGTTTA -> CGGGTGCTACGATAGTTTAC
ACACCGTTCGGCCTCCCCGT -> CACCGTTCGGCCTCCCCGTA
AGTATCAAGATATAACACCG -> GTATCAAGATATAACACCGC
TATAGCCTAATATGATTGTA -> ATAGCCTAATATGATTGTAG
GTGGTCAGTAGACCTTACCG -> TGGTCAGTAGACCTTACCGC
GCGATCGCGGGGCCCTCTAG -> CGATCGCGGGGCCCTCTAGT
CAGGCGCTTGTTTATTTAGC -> AGGCGCTTGTTTATTTAGCC
AGAGCTGCGTGAATAGGAGT -> GAGCTGCGTGAATAGGAGTG
TGTAAGGTTCGGGTGCTACG -> GTAAGGTTCGGGTGCTACGA
GGGACCCGAGGTACCTCAAG -> GGACCCGAGGTACCTCAAGT
ACCTGAATCGTACTCTTGCT -> CCTGAATCGTACTCTTGCTC
GTTCGGCCAGATCGAGCTGC -> TTCGGCCAGATCGAGCTGCT
CATCAAGATCAATTACAGGA -> ATCAAGATCAATTACAGGAC
GAGCTGCGTGAATAGGAGTG -> AGCTGCGTGAATAGGAGTGC
GGTATGAGCAAGTTGCATCT -> GTATGAGCAAGTTGCATCTG
GATTGACTCGTGTTGTGAGA -> ATTGACTCGTGTTGTGAGAG
CGACCGGCACGGTCGTCGAG -> GACCGGCACGGTCGTCGAGG
AGGCTTGCTCACTCTTCTAA -> GGCTTGCTCACTCTTCTAAA
TACGTGAATGCGTCAGCTTT -> ACGTGAATGCGTCAGCTTTC
CGTGAATGCGTCAGCTTTCG -> GTGAATGCGTCAGCTTTCGG
CCGTTCGGCCTCCCCGTAAC -> CGTTCGGCCTCCCCGTAACC
TACCGCGTAGTCGCGTTCGG -> ACCGCGTAGTCGCGTTCGGC
TGCGTGAATAGGAGTGCAAC -> GCGTGAATAGGAGTGCAACG
CGAGAATGGGCATGGCAATG -> GAGAATGGGCATGGCAATGG
GACAACCTGTAAATTGTCGT -> ACAACCTGTAAATTGTCGTG
TAAGATTGTCGGGGAATAGC -> AAGATTGTCGGGGAATAGCT
ACCGCTTCCCCGGGTGCAGA -> CCGCTTCCCCGGGTGCAGAA
CATGGATCTACCTACGTGAA -> ATGGATCTACCTACGTGAAT
TCGTACGCGTGGTCAGTAGA -> CGTACGCGTGGTCAGTAGAC
TGGTACTTGGGCTATACGAC -> GGTACTTGGGCTATACGACC
AATTACAGGACAACCTGTAA -> ATTACAGGACAACCTGTAAA
TAAATTGTCGTGCAAGCCCG -> AAATTGTCGTGCAAGCCCGT
TACCTACGTGAATGCGTCAG -> ACCTACGTGAATGCGTCAGC
CGGCTGGTACCAAATTGTTG -> GGCTGGTACCAAATTGTTGA
ATGTAAGTATATTACCGCGT -> TGTAAGTATATTACCGCGTA
TGTGAGAGCTGCGTGAATAG -> GTGAGAGCTGCGTGAATAGG
TGTTTATTTAGCCTCAACTG -> GTTTATTTAGCCTCAACTGA
GGTGGCGTACCTGGGTATGA -> GTGGCGTACCTGGGTATGAG
TATGTAAGTATATTACCGCG -> ATGTAAGTATATTACCGCGT
AACCGGCACGAGAACTCAAA -> ACCGGCACGAGAACTCAAAG
CAGTATCAAGATATAACACC -> AGTATCAAGATATAACACCG
TGGCAATGGGTGGATCCGGG -> GGCAATGGGTGGATCCGGGC
TCTTACGGTTATGCCAAAAA -> CTTACGGTTATGCCAAAAAT
GGCTATACGACCTGGCGTCC -> GCTATACGACCTGGCGTCCG
TTGTCGTGCAAGCCCGTCAG -> TGTCGTGCAAGCCCGTCAGG
GTTGGAGAGGATGCCGTATT -> TTGGAGAGGATGCCGTATTT
AAATGTAAGCTCCTGCCATC -> AATGTAAGCTCCTGCCATCA
GTAAGTATATTACCGCGTAG -> TAAGTATATTACCGCGTAGT
GTCAGGCGCAAATATAGCCT -> TCAGGCGCAAATATAGCCTA