AAAAATGACTA -> AAAATGACTAC
AAAACATAGGG -> AAACATAGGGG
AAAACCAAAAA -> AAACCAAAAAT
AAAACGCGGCC -> AAACGCGGCCG
AAAAGAACCGT -> AAAGAACCGTA
AAAAGATACTT -> AAAGATACTTG
AAAATAATGAA -> AAATAATGAAA
AAAATATTTAC -> AAATATTTACA
AAAATGATTGT -> AAATGATTGTC
AAACATAGGGG -> AACATAGGGGC
AAACCAAAAAT -> AACCAAAAATG
AAACCGTAGGT -> AACCGTAGGTT
AAACGATTGGG -> AACGATTGGGT
AAACGCGGCCG -> AACGCGGCCGA
AAACGGCTTTC -> AACGGCTTTCA
AAACTGTATCC -> AACTGTATCCT
AAAGAACCGTA -> AAGAACCGTAC
AAAGATACTTG -> AAGATACTTGG
AAAGATCTCTG -> AAGATCTCTGG
AAAGCTAATCC -> AAGCTAATCCG
AAATAATGAAA -> AATAATGAAAG
AAATAGAGCCA -> AATAGAGCCAG
AAATATTTACA -> AATATTTACAC
AAATCAAAGCT -> AATCAAAGCTA
AAATGATTGTC -> AATGATTGTCG
AAATGCCTAAC -> AATGCCTAACG
AAATTTTTTAA -> AATTTTTTAAT
AACACCGTCCT -> ACACCGTCCTG
AACACCGTGTA -> ACACCGTGTAC
AACACTTAGTC -> ACACTTAGTCT
AACAGAGCCGG -> ACAGAGCCGGG
AACAGCACATG -> ACAGCACATGA
AACAGTGGACA -> ACAGTGGACAC
AACATAGGGGC -> ACATAGGGGCT
AACATCAGCCA -> ACATCAGCCAG
AACATGAAAAC -> ACATGAAAACC
AACATGCATCT -> ACATGCATCTA
AACATTAAGAA -> ACATTAAGAAC
AACATTAGATT -> ACATTAGATTG
AACCAAAAATG -> ACCAAAAATGA
AACCACTACGA -> ACCACTACGAG
AACCAGAGCTC -> ACCAGAGCTCC
AACCGAACCAG -> ACCGAACCAGA
AACCGTACTGG -> ACCGTACTGGG
AACCGTAGGTT -> ACCGTAGGTTA
AACCTCTGATT -> ACCTCTGATTG
AACGACTGACG -> ACGACTGACGT
AACGAGCCGCA -> ACGAGCCGCAT
AACGAGGTGAT -> ACGAGGTGATC
AACGATTGGGT -> ACGATTGGGTG
AACGCACTAAC -> ACGCACTAACC
AACGCACTTAG -> ACGCACTTAGG
AACGCGCGGAA -> ACGCGCGGAAG
AACGCGGCCGA -> ACGCGGCCGAG
AACGGCCCTCG -> ACGGCCCTCGC
AACGGCTTTCA -> ACGGCTTTCAC
AACTAAATTTT -> ACTAAATTTTT
AACTAGCCCTT -> ACTAGCCCTTT
AACTCAGGTTG -> ACTCAGGTTGA
AACTCTATCTC -> ACTCTATCTCA
AACTGACCATT -> ACTGACCATTT
AACTGATGAGA -> ACTGATGAGAC
AACTGGCATTT -> ACTGGCATTTC
AACTGGCTGTC -> ACTGGCTGTCG
AACTGTATCCT -> ACTGTATCCTT
AACTTGGGGCA -> ACTTGGGGCAT
AACTTTACCTT -> ACTTTACCTTT
AAGAACATGAA -> AGAACATGAAA
AAGAACCGTAC -> AGAACCGTACT
AAGAAGGAGCG -> AGAAGGAGCGT
AAGACAAGAGC -> AGACAAGAGCT
AAGACAGCTGT -> AGACAGCTGTG
AAGACCAAAAC -> AGACCAAAACG
AAGAGCCTACA -> AGAGCCTACAC
AAGAGCTCAAG -> AGAGCTCAAGA
AAGAGGCTGTC -> AGAGGCTGTCG
AAGATACTTGG -> AGATACTTGGT
AAGATCTCTGG -> AGATCTCTGGA
AAGATGTAGCA -> AGATGTAGCAT
AAGCTAATCCG -> AGCTAATCCGA
AAGGAATCACA -> AGGAATCACAT
AAGGAGCGTGA -> AGGAGCGTGAC
AAGGCTCGATC -> AGGCTCGATCT
AAGGCTGAATC -> AGGCTGAATCC
AAGGGAACACC -> AGGGAACACCG
AAGGTCTTCAA -> AGGTCTTCAAA
AAGGTGATCTG -> AGGTGATCTGA
AAGTATCAGAG -> AGTATCAGAGT
AAGTCTATTTA -> AGTCTATTTAA
AAGTCTGTGGT -> AGTCTGTGGTA
AAGTGGCCCCG -> AGTGGCCCCGC
AAGTTAGCCGC -> AGTTAGCCGCT
AATAACAGCAC -> ATAACAGCACA
AATAACTCTAT -> ATAACTCTATC
AATAATCTGAC -> ATAATCTGACT
AATAATGAAAG -> ATAATGAAAGA
AATACACTCGA -> ATACACTCGAG
AATAGAGCCAG -> ATAGAGCCAGA
AATATGGAAGG -> ATATGGAAGGT
AATATTTACAC -> ATATTTACACA
AATCAAAGCTA -> ATCAAAGCTAA
AATCACATTTA -> ATCACATTTAA
AATCAGAACTT -> ATCAGAACTTG
AATCAGTACAG -> ATCAGTACAGA
AATCCACATTG -> ATCCACATTGT
AATCCATACGA -> ATCCATACGAC
AATCCGAGACC -> ATCCGAGACCG
AATCGACGAAT -> ATCGACGAATC
AATCTGACTCC -> ATCTGACTCCT
AATGAAAGATC -> ATGAAAGATCT
AATGAGTTTTC -> ATGAGTTTTCT
AATGATTGTCG -> ATGATTGTCGA
AATGCCACGAT -> ATGCCACGATC
AATGCCTAACG -> ATGCCTAACGA
AATGGGCGCCT -> ATGGGCGCCTT
AATTCAAGGTG -> ATTCAAGGTGA
AATTGGCCTTC -> ATTGGCCTTCC
AATTGTTATGG -> ATTGTTATGGC
AATTTCCTCTT -> ATTTCCTCTTG
AATTTTTTAAT -> ATTTTTTAATT
ACAAGAGCTCA -> CAAGAGCTCAA
ACAAGAGGCTG -> CAAGAGGCTGT
ACAATGGGCGC -> CAATGGGCGCC
ACACAGAACCT -> CACAGAACCTC
ACACAGCTTAT -> CACAGCTTATC
ACACATGCGCA -> CACATGCGCAC
ACACCCCTGGC -> CACCCCTGGCG
ACACCGACAGG -> CACCGACAGGT
ACACCGTCCTG -> CACCGTCCTGA
ACACCGTCTGA -> CACCGTCTGAG
ACACCGTGTAC -> CACCGTGTACG
ACACGCGGATT -> CACGCGGATTG
ACACGGCGTCC -> CACGGCGTCCT
ACACGTTCGGT -> CACGTTCGGTC
ACACTAGGCTG -> CACTAGGCTGG
ACACTCGAGAA -> CACTCGAGAAA
ACACTGAGCCG -> CACTGAGCCGA
ACACTTAGTCT -> CACTTAGTCTG
ACAGAACCTCT -> CAGAACCTCTG
ACAGAATCAGA -> CAGAATCAGAA
ACAGAGCCGGG -> CAGAGCCGGGC
ACAGATCGTAG -> CAGATCGTAGA
ACAGCAATACA -> CAGCAATACAC
ACAGCACATGA -> CAGCACATGAC
ACAGCGGTTGG -> CAGCGGTTGGA
ACAGCTGTGTT -> CAGCTGTGTTG
ACAGCTTATCT -> CAGCTTATCTT
ACAGGTATCGT -> CAGGTATCGTC
ACAGTGGACAC -> CAGTGGACACC
ACATAGGGGCT -> CATAGGGGCTT
ACATCAGCCAG -> CATCAGCCAGT
ACATGAAAACC -> CATGAAAACCA
ACATGACACCG -> CATGACACCGA
ACATGAGTATT -> CATGAGTATTC
ACATGCATCTA -> CATGCATCTAT
ACATGCGCACT -> CATGCGCACTT
ACATTAAGAAC -> CATTAAGAACA
ACATTAGATTG -> CATTAGATTGA
ACATTGTAGTG -> CATTGTAGTGG
ACATTTAAGTC -> CATTTAAGTCT
ACCAAAAATGA -> CCAAAAATGAC
ACCAAAACGCG -> CCAAAACGCGG
ACCACCTAGTA -> CCACCTAGTAG
ACCACGGAGTT -> CCACGGAGTTG
ACCACTACGAG -> CCACTACGAGT
ACCAGAGCTCC -> CCAGAGCTCCA
ACCATGCTAAG -> CCATGCTAAGG
ACCATTTCCAT -> CCATTTCCATT
ACCCACGGAGC -> CCCACGGAGCT
ACCCCTGGCAA -> CCCCTGGCAAC
ACCCCTGGCGT -> CCCCTGGCGTT
ACCCTTCCGAT -> CCCTTCCGATT
ACCCTTTGCAA -> CCCTTTGCAAC
ACCGAACCAGA -> CCGAACCAGAG
ACCGACAGGTA -> CCGACAGGTAT
ACCGATGGGGG -> CCGATGGGGGA
ACCGATTCCCT -> CCGATTCCCTT
ACCGCTATAAC -> CCGCTATAACA
ACCGCTCGTGT -> CCGCTCGTGTA
ACCGGTATATC -> CCGGTATATCG
ACCGTACCTAA -> CCGTACCTAAC
ACCGTACTGGG -> CCGTACTGGGA
ACCGTAGGTTA -> CCGTAGGTTAT
ACCGTCCTGAA -> CCGTCCTGAAC
ACCGTCTGAGC -> CCGTCTGAGCT
ACCGTGTACGC -> CCGTGTACGCA
ACCTAACTTTA -> CCTAACTTTAC
ACCTAGAGTGT -> CCTAGAGTGTC
ACCTAGTAGCT -> CCTAGTAGCTA
ACCTCGACGCG -> CCTCGACGCGC
ACCTCTGATTG -> CCTCTGATTGT
ACCTGCTGAGG -> CCTGCTGAGGT
ACCTTTCACTC -> CCTTTCACTCC
ACCTTTTATGA -> CCTTTTATGAA
ACGAATATGGA -> CGAATATGGAA
ACGAATCCATA -> CGAATCCATAC
ACGAATTGTTA -> CGAATTGTTAT
ACGACACGCGG -> CGACACGCGGA
ACGACCACGGA -> CGACCACGGAG
ACGACTGACGT -> CGACTGACGTG
ACGAGCCGCAT -> CGAGCCGCATA
ACGAGGTGATC -> CGAGGTGATCT
ACGAGTCACAC -> CGAGTCACACC
ACGATCCGTGG -> CGATCCGTGGA
ACGATTGGGTG -> CGATTGGGTGA
ACGCAAGACAA -> CGCAAGACAAG
ACGCACCCTTT -> CGCACCCTTTG
ACGCACTAACC -> CGCACTAACCA
ACGCACTTAGG -> CGCACTTAGGT
ACGCCAAGGCT -> CGCCAAGGCTG
ACGCCATAATG -> CGCCATAATGA
ACGCGCGGAAG -> CGCGCGGAAGA
ACGCGCTGTTC -> CGCGCTGTTCT
ACGCGGATTGA -> CGCGGATTGAG
ACGCGGCCGAG -> CGCGGCCGAGA
ACGCTCGCACG -> CGCTCGCACGG
ACGGAGAGAGC -> CGGAGAGAGCG
ACGGAGATTAG -> CGGAGATTAGT
ACGGAGCTCTT -> CGGAGCTCTTT
ACGGAGTTGTC -> CGGAGTTGTCG
ACGGCACCCAC -> CGGCACCCACG
ACGGCACGCAA -> CGGCACGCAAG
ACGGCCCTCGC -> CGGCCCTCGCT
ACGGCGTCCTA -> CGGCGTCCTAA
ACGGCTTTCAC -> CGGCTTTCACC
ACGGTTGCAAA -> CGGTTGCAAAC
ACGTATTATCG -> CGTATTATCGC
ACGTGACCTGC -> CGTGACCTGCT
ACGTGCGGAGC -> CGTGCGGAGCA
ACGTGGTAAGT -> CGTGGTAAGTA
ACGTGTTAGAC -> CGTGTTAGACG
ACGTTCGGTCC -> CGTTCGGTCCC
ACTAAATTTTT -> CTAAATTTTTT
ACTAACCACTA -> CTAACCACTAC
ACTACGAGTCA -> CTACGAGTCAC
ACTAGCCCTTT -> CTAGCCCTTTG
ACTAGCTCCAA -> CTAGCTCCAAG
ACTAGGCTGGG -> CTAGGCTGGGG
ACTCAGGTTGA -> CTCAGGTTGAT
ACTCATTAAAA -> CTCATTAAAAT
ACTCCGCCTCG -> CTCCGCCTCGT
ACTCCTGCCAG -> CTCCTGCCAGC
ACTCGAGAAAC -> CTCGAGAAACT
ACTCTATCTCA -> CTCTATCTCAA
ACTGACCATTT -> CTGACCATTTC
ACTGACGTGGT -> CTGACGTGGTA
ACTGAGCCGAA -> CTGAGCCGAAG
ACTGATGAGAC -> CTGATGAGACC
ACTGGAATGCC -> CTGGAATGCCA
ACTGGCATTTC -> CTGGCATTTCT
ACTGGCTGTCG -> CTGGCTGTCGC
ACTGGGATGCG -> CTGGGATGCGG
ACTGGGGTGTT -> CTGGGGTGTTT
ACTGTATCCTT -> CTGTATCCTTC
ACTTAGGTCCT -> CTTAGGTCCTG
ACTTAGTCTGC -> CTTAGTCTGCC
ACTTCCTCGAG -> CTTCCTCGAGT
ACTTGGGGCAT -> CTTGGGGCATT
ACTTGGTCCCC -> CTTGGTCCCCC
ACTTGTAACGA -> CTTGTAACGAG
ACTTTACCTTT -> CTTTACCTTTT
ACTTTCGCGTT -> CTTTCGCGTTA
AGAAACGATTG -> GAAACGATTGG
AGAAACTGTAT -> GAAACTGTATC
AGAACATGAAA -> GAACATGAAAA
AGAACCGTACT -> GAACCGTACTG
AGAACCTCTGA -> GAACCTCTGAT
AGAACTTGGGG -> GAACTTGGGGC
AGAAGGAGCGT -> GAAGGAGCGTG
AGAATCAGAAC -> GAATCAGAACT
AGACAAGAGCT -> GACAAGAGCTC
AGACACGGCGT -> GACACGGCGTC
AGACACGTTCG -> GACACGTTCGG
AGACAGCTGTG -> GACAGCTGTGT
AGACCAAAACG -> GACCAAAACGC
AGACCGATGGG -> GACCGATGGGG
AGACCGGTATA -> GACCGGTATAT
AGACGGCACGC -> GACGGCACGCA
AGACTAGCTCC -> GACTAGCTCCA
AGAGAGCGGGA -> GAGAGCGGGAA
AGAGCCAGACA -> GAGCCAGACAC
AGAGCCGGGCG -> GAGCCGGGCGG
AGAGCCTACAC -> GAGCCTACACT
AGAGCGGGAAA -> GAGCGGGAAAT
AGAGCTATACT -> GAGCTATACTT
AGAGCTCAAGA -> GAGCTCAAGAT
AGAGCTCCAGT -> GAGCTCCAGTA
AGAGGCATCGG -> GAGGCATCGGA
AGAGGCTGTCG -> GAGGCTGTCGT
AGAGTCGCTCG -> GAGTCGCTCGA
AGAGTCTATTA -> GAGTCTATTAG
AGAGTGTCAAC -> GAGTGTCAACT
AGAGTTCTTCG -> GAGTTCTTCGA
AGATACACTAG -> GATACACTAGG
AGATACTTGGT -> GATACTTGGTC
AGATCGTAGAC -> GATCGTAGACT
AGATCTCTGGA -> GATCTCTGGAC
AGATGTAGCAT -> GATGTAGCATC
AGATTAAGAAG -> GATTAAGAAGG
AGATTAGTGAC -> GATTAGTGACG
AGATTGAAATA -> GATTGAAATAG
AGCAAAATAAT -> GCAAAATAATG
AGCAACGGCCC -> GCAACGGCCCT
AGCAATACACT -> GCAATACACTC
AGCACATGACA -> GCACATGACAC
AGCACGCCATA -> GCACGCCATAA
AGCAGCAGTTG -> GCAGCAGTTGC
AGCAGTTGCCG -> GCAGTTGCCGA
AGCATAAGTGG -> GCATAAGTGGC
AGCATCAACGC -> GCATCAACGCA
AGCCAGACACG -> GCCAGACACGG
AGCCAGGCAGC -> GCCAGGCAGCA
AGCCAGTAAAT -> GCCAGTAAATG
AGCCCGCTTTA -> GCCCGCTTTAG
AGCCCTTTGGA -> GCCCTTTGGAG
AGCCGAAGGAA -> GCCGAAGGAAT
AGCCGCATAGG -> GCCGCATAGGT
AGCCGCTCCGG -> GCCGCTCCGGG
AGCCGGGCGGG -> GCCGGGCGGGC
AGCCTACACTG -> GCCTACACTGA
AGCCTCGTTCG -> GCCTCGTTCGA
AGCGGGAAATC -> GCGGGAAATCA
AGCGGTTGGAC -> GCGGTTGGACC
AGCGTGACAGA -> GCGTGACAGAA
AGCTAACGAGG -> GCTAACGAGGT
AGCTAATCCGA -> GCTAATCCGAG
AGCTATACTTC -> GCTATACTTCC
AGCTCAAGATG -> GCTCAAGATGT
AGCTCCAAGAC -> GCTCCAAGACC
AGCTCCAGTAT -> GCTCCAGTATC
AGCTCTGGCTT -> GCTCTGGCTTT
AGCTCTTTCCC -> GCTCTTTCCCA
AGCTGCACGCC -> GCTGCACGCCA
AGCTGTGTTGG -> GCTGTGTTGGT
AGCTTATCTTC -> GCTTATCTTCC
AGCTTCTTTAG -> GCTTCTTTAGT
AGGAACTAAAT -> GGAACTAAATT
AGGAATCACAT -> GGAATCACATT
AGGACACAGAA -> GGACACAGAAC
AGGACAGCAAT -> GGACAGCAATA
AGGACGACACG -> GGACGACACGC
AGGAGCGTGAC -> GGAGCGTGACA
AGGCAGCAACG -> GGCAGCAACGG
AGGCATCGGAA -> GGCATCGGAAC
AGGCGTAGTTT -> GGCGTAGTTTA
AGGCTCGATCT -> GGCTCGATCTA
AGGCTGAATCC -> GGCTGAATCCA
AGGCTGGGGAT -> GGCTGGGGATA
AGGCTGTCGTG -> GGCTGTCGTGT
AGGCTTTTGAA -> GGCTTTTGAAT
AGGGAACACCG -> GGGAACACCGT
AGGGGCTTGCG -> GGGGCTTGCGC
AGGGTTTGAGT -> GGGTTTGAGTG
AGGTAGCTTCT -> GGTAGCTTCTT
AGGTAGGACGA -> GGTAGGACGAC
AGGTATCGTCA -> GGTATCGTCAC
AGGTCCTGACG -> GGTCCTGACGT
AGGTCTTCAAA -> GGTCTTCAAAA
AGGTGAGCATA -> GGTGAGCATAA
AGGTGATCTGA -> GGTGATCTGAC
AGGTGATCTGG -> GGTGATCTGGA
AGGTTATATGC -> GGTTATATGCT
AGGTTGATGTA -> GGTTGATGTAG
AGTAAATGCCT -> GTAAATGCCTA
AGTACAGATCG -> GTACAGATCGT
AGTAGCTAACG -> GTAGCTAACGA
AGTATCAATAA -> GTATCAATAAT
AGTATCAGAGT -> GTATCAGAGTT
AGTATTCGACG -> GTATTCGACGT
AGTCACACCGT -> GTCACACCGTC
AGTCACCTCGA -> GTCACCTCGAC
AGTCGCTCGAA -> GTCGCTCGAAA
AGTCTATTAGC -> GTCTATTAGCA
AGTCTATTTAA -> GTCTATTTAAT
AGTCTGCCGAC -> GTCTGCCGACA
AGTCTGTGGTA -> GTCTGTGGTAA
AGTGACGTGTT -> GTGACGTGTTA
AGTGAGCCAGG -> GTGAGCCAGGC
AGTGGACACCC -> GTGGACACCCC
AGTGGACTTGT -> GTGGACTTGTA
AGTGGCCCCGC -> GTGGCCCCGCG
AGTGTACGAAT -> GTGTACGAATT
AGTGTCAACTC -> GTGTCAACTCA
AGTTACGCTCG -> GTTACGCTCGC
AGTTAGCCGCT -> GTTAGCCGCTC
AGTTCTTCGAC -> GTTCTTCGACT
AGTTGCCGAGA -> GTTGCCGAGAA
AGTTGTCGACC -> GTTGTCGACCG
AGTTTAGAGTC -> GTTTAGAGTCG
AGTTTTCTATT -> GTTTTCTATTT
ATAACACTTAG -> TAACACTTAGT
ATAACAGCACA -> TAACAGCACAT
ATAACTCTATC -> TAACTCTATCT
ATAAGTGGCCC -> TAAGTGGCCCC
ATAATCTGACT -> TAATCTGACTC
ATAATGAAAGA -> TAATGAAAGAT
ATAATGAGTTT -> TAATGAGTTTT
ATACACTAGGC -> TACACTAGGCT
ATACACTCGAG -> TACACTCGAGA
ATACGACCACG -> TACGACCACGG
ATACTTCCTCG -> TACTTCCTCGA
ATACTTGGTCC -> TACTTGGTCCC
ATAGAGCCAGA -> TAGAGCCAGAC
ATAGGGGCTTG -> TAGGGGCTTGC
ATAGGTAGCTT -> TAGGTAGCTTC
ATATCGAGGTA -> TATCGAGGTAG
ATATGCTCGAT -> TATGCTCGATG
ATATGGAAGGT -> TATGGAAGGTC
ATATTTACACA -> TATTTACACAG
ATATTTGTCGC -> TATTTGTCGCG
ATCAAAGCTAA -> TCAAAGCTAAT
ATCAACGCACT -> TCAACGCACTT
ATCAATAATCT -> TCAATAATCTG
ATCACATTTAA -> TCACATTTAAG
ATCAGAACTTG -> TCAGAACTTGG
ATCAGAGTTCT -> TCAGAGTTCTT
ATCAGCCAGTA -> TCAGCCAGTAA
ATCAGTACAGA -> TCAGTACAGAT
ATCCACATTGT -> TCCACATTGTA
ATCCATACGAC -> TCCATACGACC
ATCCGAGACCG -> TCCGAGACCGA
ATCCGTAATTT -> TCCGTAATTTC
ATCCGTGGAAT -> TCCGTGGAATC
ATCCTTCCGAC -> TCCTTCCGACT
ATCGACGAATC -> TCGACGAATCC
ATCGAGGTAGG -> TCGAGGTAGGA
ATCGCCGTGCC -> TCGCCGTGCCG
ATCGCGGCAAC -> TCGCGGCAACA
ATCGGAACGCA -> TCGGAACGCAC
ATCGGCCTTAG -> TCGGCCTTAGG
ATCGTAGACTA -> TCGTAGACTAG
ATCGTCACGGA -> TCGTCACGGAG
ATCTACGTATT -> TCTACGTATTA
ATCTATGAGGA -> TCTATGAGGAC
ATCTCAACGCG -> TCTCAACGCGC
ATCTCTGGACA -> TCTCTGGACAA
ATCTGACGGCA -> TCTGACGGCAC
ATCTGACTCCT -> TCTGACTCCTG
ATCTGGAGTCA -> TCTGGAGTCAC
ATCTGGGGTTA -> TCTGGGGTTAG
ATCTTCCATCC -> TCTTCCATCCG
ATGAAAACCAA -> TGAAAACCAAA
ATGAAAGATCT -> TGAAAGATCTC
ATGAAGAGCCT -> TGAAGAGCCTA
ATGACACCGAC -> TGACACCGACA
ATGAGACCGGT -> TGAGACCGGTA
ATGAGGACAGC -> TGAGGACAGCA
ATGAGTATTCG -> TGAGTATTCGA
ATGAGTTTTCT -> TGAGTTTTCTA
ATGATTGTCGA -> TGATTGTCGAG
ATGCATCTATG -> TGCATCTATGA
ATGCCACGATC -> TGCCACGATCC
ATGCCTAACGA -> TGCCTAACGAC
ATGCGCACTTT -> TGCGCACTTTC
ATGCGGCTTTG -> TGCGGCTTTGG
ATGCTAAGGGA -> TGCTAAGGGAA
ATGCTCGATGT -> TGCTCGATGTG
ATGGAAGGTCT -> TGGAAGGTCTT
ATGGCGCTCGG -> TGGCGCTCGGT
ATGGGCGCCTT -> TGGGCGCCTTA
ATGGGGGACCA -> TGGGGGACCAC
ATGGGGTCCAC -> TGGGGTCCACG
ATGTACACATG -> TGTACACATGC
ATGTAGCATCA -> TGTAGCATCAA
ATGTAGGCTTT -> TGTAGGCTTTT
ATGTGCAAGTT -> TGTGCAAGTTA
ATGTTGCTACA -> TGTTGCTACAT
ATTAAAATATT -> TTAAAATATTT
ATTAAGAACAT -> TTAAGAACATG
ATTAAGAAGGA -> TTAAGAAGGAG
ATTAGATTGAA -> TTAGATTGAAA
ATTAGCAAAAT -> TTAGCAAAATA
ATTAGCCCGCT -> TTAGCCCGCTT
ATTAGTGACGT -> TTAGTGACGTG
ATTATCGCCGT -> TTATCGCCGTG
ATTATGTACAC -> TTATGTACACA
ATTCAAGGTGA -> TTCAAGGTGAT
ATTCCCGGACG -> TTCCCGGACGA
ATTCCCTTCCG -> TTCCCTTCCGA
ATTCCGCAACA -> TTCCGCAACAT
ATTCGACGTGA -> TTCGACGTGAC
ATTGAAATAGA -> TTGAAATAGAG
ATTGAGCACGC -> TTGAGCACGCC
ATTGCTATTGG -> TTGCTATTGGC
ATTGGCCTTCC -> TTGGCCTTCCG
ATTGGCGGCTG -> TTGGCGGCTGG
ATTGGGTGAGA -> TTGGGTGAGAG
ATTGTAGTGGA -> TTGTAGTGGAC
ATTGTCCAACA -> TTGTCCAACAC
ATTGTCGAGGG -> TTGTCGAGGGT
ATTGTTATGGC -> TTGTTATGGCG
ATTTAACATTA -> TTTAACATTAA
ATTTAAGTCTG -> TTTAAGTCTGT
ATTTAATCGAC -> TTTAATCGACG
ATTTACACAGC -> TTTACACAGCT
ATTTCCATTAG -> TTTCCATTAGC
ATTTCCTCTTG -> TTTCCTCTTGG
ATTTCTCTTTC -> TTTCTCTTTCA
ATTTCTTAACT -> TTTCTTAACTG
ATTTGTCGCGG -> TTTGTCGCGGC
ATTTTTTAATT -> TTTTTTAATTC
CAAAAATGACT -> AAAAATGACTA
CAAAACATAGG -> AAAACATAGGG
CAAAACGCGGC -> AAAACGCGGCC
CAAAAGAACCG -> AAAAGAACCGT
CAAAATAATGA -> AAAATAATGAA
CAAACCGTAGG -> AAACCGTAGGT
CAAAGCTAATC -> AAAGCTAATCC
CAACACCGTCC -> AACACCGTCCT
CAACAGAGCCG -> AACAGAGCCGG
CAACATCAGCC -> AACATCAGCCA
CAACATGCATC -> AACATGCATCT
CAACATTAGAT -> AACATTAGATT
CAACGCACTTA -> AACGCACTTAG
CAACGCGCGGA -> AACGCGCGGAA
CAACGGCCCTC -> AACGGCCCTCG
CAACTAGCCCT -> AACTAGCCCTT
CAACTCAGGTT -> AACTCAGGTTG
CAACTGGCATT -> AACTGGCATTT
CAAGACAAGAG -> AAGACAAGAGC
CAAGACCAAAA -> AAGACCAAAAC
CAAGAGCTCAA -> AAGAGCTCAAG
CAAGAGGCTGT -> AAGAGGCTGTC
CAAGATGTAGC -> AAGATGTAGCA
CAAGGCTGAAT -> AAGGCTGAATC
CAAGGTGATCT -> AAGGTGATCTG
CAAGTCTATTT -> AAGTCTATTTA
CAAGTTAGCCG -> AAGTTAGCCGC
CAATAATCTGA -> AATAATCTGAC
CAATACACTCG -> AATACACTCGA
CAATGGGCGCC -> AATGGGCGCCT
CACACCGTCTG -> ACACCGTCTGA
CACAGAACCTC -> ACAGAACCTCT
CACAGCGGTTG -> ACAGCGGTTGG
CACAGCTTATC -> ACAGCTTATCT
CACATGACACC -> ACATGACACCG
CACATGCGCAC -> ACATGCGCACT
CACATTGTAGT -> ACATTGTAGTG
CACATTTAAGT -> ACATTTAAGTC
CACCATGCTAA -> ACCATGCTAAG
CACCCACGGAG -> ACCCACGGAGC
CACCCCTGGCA -> ACCCCTGGCAA
CACCCCTGGCG -> ACCCCTGGCGT
CACCCTTCCGA -> ACCCTTCCGAT
CACCCTTTGCA -> ACCCTTTGCAA
CACCGACAGGT -> ACCGACAGGTA
CACCGATTCCC -> ACCGATTCCCT
CACCGTACCTA -> ACCGTACCTAA
CACCGTCCTGA -> ACCGTCCTGAA
CACCGTCTGAG -> ACCGTCTGAGC
CACCGTGTACG -> ACCGTGTACGC
CACCTAGTAGC -> ACCTAGTAGCT
CACCTCGACGC -> ACCTCGACGCG
CACGATCCGTG -> ACGATCCGTGG
CACGCAAGACA -> ACGCAAGACAA
CACGCCAAGGC -> ACGCCAAGGCT
CACGCCATAAT -> ACGCCATAATG
CACGCGGATTG -> ACGCGGATTGA
CACGGAGAGAG -> ACGGAGAGAGC
CACGGAGATTA -> ACGGAGATTAG
CACGGAGCTCT -> ACGGAGCTCTT
CACGGAGTTGT -> ACGGAGTTGTC
CACGGCGTCCT -> ACGGCGTCCTA
CACGGTTGCAA -> ACGGTTGCAAA
CACGTTCGGTC -> ACGTTCGGTCC
CACTAACCACT -> ACTAACCACTA
CACTACGAGTC -> ACTACGAGTCA
CACTAGGCTGG -> ACTAGGCTGGG
CACTCATTAAA -> ACTCATTAAAA
CACTCCGCCTC -> ACTCCGCCTCG
CACTCGAGAAA -> ACTCGAGAAAC
CACTGAGCCGA -> ACTGAGCCGAA
CACTTAGGTCC -> ACTTAGGTCCT
CACTTAGTCTG -> ACTTAGTCTGC
CACTTTCGCGT -> ACTTTCGCGTT
CAGAACCTCTG -> AGAACCTCTGA
CAGAACTTGGG -> AGAACTTGGGG
CAGAATCAGAA -> AGAATCAGAAC
CAGACACGGCG -> AGACACGGCGT
CAGACACGTTC -> AGACACGTTCG
CAGAGCCGGGC -> AGAGCCGGGCG
CAGAGCTCCAG -> AGAGCTCCAGT
CAGAGTTCTTC -> AGAGTTCTTCG
CAGATCGTAGA -> AGATCGTAGAC
CAGATTAAGAA -> AGATTAAGAAG
CAGCAACGGCC -> AGCAACGGCCC
CAGCAATACAC -> AGCAATACACT
CAGCACATGAC -> AGCACATGACA
CAGCAGTTGCC -> AGCAGTTGCCG
CAGCCAGTAAA -> AGCCAGTAAAT
CAGCCTCGTTC -> AGCCTCGTTCG
CAGCGGTTGGA -> AGCGGTTGGAC
CAGCTGTGTTG -> AGCTGTGTTGG
CAGCTTATCTT -> AGCTTATCTTC
CAGGCAGCAAC -> AGGCAGCAACG
CAGGCGTAGTT -> AGGCGTAGTTT
CAGGTATCGTC -> AGGTATCGTCA
CAGGTTGATGT -> AGGTTGATGTA
CAGTAAATGCC -> AGTAAATGCCT
CAGTACAGATC -> AGTACAGATCG
CAGTATCAATA -> AGTATCAATAA
CAGTGGACACC -> AGTGGACACCC
CAGTTGCCGAG -> AGTTGCCGAGA
CATAAGTGGCC -> ATAAGTGGCCC
CATAATGAGTT -> ATAATGAGTTT
CATACGACCAC -> ATACGACCACG
CATAGGGGCTT -> ATAGGGGCTTG
CATAGGTAGCT -> ATAGGTAGCTT
CATCAACGCAC -> ATCAACGCACT
CATCAGCCAGT -> ATCAGCCAGTA
CATCCGTAATT -> ATCCGTAATTT
CATCGCGGCAA -> ATCGCGGCAAC
CATCGGAACGC -> ATCGGAACGCA
CATCTATGAGG -> ATCTATGAGGA
CATGAAAACCA -> ATGAAAACCAA
CATGACACCGA -> ATGACACCGAC
CATGAGTATTC -> ATGAGTATTCG
CATGCATCTAT -> ATGCATCTATG
CATGCGCACTT -> ATGCGCACTTT
CATGCTAAGGG -> ATGCTAAGGGA
CATGGGGTCCA -> ATGGGGTCCAC
CATTAAAATAT -> ATTAAAATATT
CATTAAGAACA -> ATTAAGAACAT
CATTAGATTGA -> ATTAGATTGAA
CATTAGCCCGC -> ATTAGCCCGCT
CATTCCCGGAC -> ATTCCCGGACG
CATTGTAGTGG -> ATTGTAGTGGA
CATTTAAGTCT -> ATTTAAGTCTG
CATTTCCATTA -> ATTTCCATTAG
CATTTCTCTTT -> ATTTCTCTTTC
CATTTCTTAAC -> ATTTCTTAACT
CCAAAAATGAC -> CAAAAATGACT
CCAAAACGCGG -> CAAAACGCGGC
CCAAAAGAACC -> CAAAAGAACCG
CCAACACCGTC -> CAACACCGTCC
CCAACATGCAT -> CAACATGCATC
CCAACATTAGA -> CAACATTAGAT
CCAAGACCAAA -> CAAGACCAAAA
CCAAGGCTGAA -> CAAGGCTGAAT
CCACAGCGGTT -> CACAGCGGTTG
CCACATTGTAG -> CACATTGTAGT
CCACCGTACCT -> CACCGTACCTA
CCACCTAGTAG -> CACCTAGTAGC
CCACGATCCGT -> CACGATCCGTG
CCACGGAGCTC -> CACGGAGCTCT
CCACGGAGTTG -> CACGGAGTTGT
CCACGGTTGCA -> CACGGTTGCAA
CCACTACGAGT -> CACTACGAGTC
CCAGACACGGC -> CAGACACGGCG
CCAGAGCTCCA -> CAGAGCTCCAG
CCAGATTAAGA -> CAGATTAAGAA
CCAGCCTCGTT -> CAGCCTCGTTC
CCAGGCAGCAA -> CAGGCAGCAAC
CCAGTAAATGC -> CAGTAAATGCC
CCAGTATCAAT -> CAGTATCAATA
CCATAATGAGT -> CATAATGAGTT
CCATACGACCA -> CATACGACCAC
CCATCCGTAAT -> CATCCGTAATT
CCATGCTAAGG -> CATGCTAAGGG
CCATTAGCCCG -> CATTAGCCCGC
CCATTTCCATT -> CATTTCCATTA
CCCAACATGCA -> CCAACATGCAT
CCCACAGCGGT -> CCACAGCGGTT
CCCACCGTACC -> CCACCGTACCT
CCCACGGAGCT -> CCACGGAGCTC
CCCAGATTAAG -> CCAGATTAAGA
CCCCACAGCGG -> CCCACAGCGGT
CCCCCACAGCG -> CCCCACAGCGG
CCCCGCGTGTA -> CCCGCGTGTAG
CCCCTGGCAAC -> CCCTGGCAACT
CCCCTGGCGTT -> CCCTGGCGTTT
CCCGCGTGTAG -> CCGCGTGTAGA
CCCGCTTTAGA -> CCGCTTTAGAG
CCCGGACGAAT -> CCGGACGAATA
CCCGTACCTAG -> CCGTACCTAGA
CCCTCACCATG -> CCTCACCATGC
CCCTCGCTTCA -> CCTCGCTTCAT
CCCTGGCAACT -> CCTGGCAACTA
CCCTGGCGTTT -> CCTGGCGTTTG
CCCTTCCGATT -> CCTTCCGATTC,CCTTCCGATTA
CCCTTTGCAAC -> CCTTTGCAACT
CCCTTTGGAGC -> CCTTTGGAGCT
CCGAACCAGAG -> CGAACCAGAGC
CCGAAGGAATC -> CGAAGGAATCA
CCGACAATGGG -> CGACAATGGGC
CCGACAGGTAT -> CGACAGGTATC
CCGACTGGGGT -> CGACTGGGGTG
CCGAGAAACGA -> CGAGAAACGAT
CCGAGACCGAT -> CGAGACCGATG
CCGAGAGTCTA -> CGAGAGTCTAT
CCGATGGGGGA -> CGATGGGGGAC
CCGATTATGTA -> CGATTATGTAC
CCGATTCCCTT -> CGATTCCCTTC
CCGATTCCGCA -> CGATTCCGCAA
CCGCAACATCA -> CGCAACATCAG
CCGCATAGGTA -> CGCATAGGTAG
CCGCATTTCTT -> CGCATTTCTTA
CCGCCTCGTGG -> CGCCTCGTGGC
CCGCGTGTAGA -> CGCGTGTAGAT
CCGCTATAACA -> CGCTATAACAC
CCGCTCAAGTC -> CGCTCAAGTCT
CCGCTCCGGGT -> CGCTCCGGGTT
CCGCTCGTGTA -> CGCTCGTGTAA
CCGCTTTAGAG -> CGCTTTAGAGG
CCGGACGAATA -> CGGACGAATAT
CCGGGCGGGCC -> CGGGCGGGCCA
CCGGGTTCCCA -> CGGGTTCCCAA
CCGGTATATCG -> CGGTATATCGA
CCGTAATTTCC -> CGTAATTTCCT
CCGTACCTAAC -> CGTACCTAACT
CCGTACCTAGA -> CGTACCTAGAG
CCGTACTGGGA -> CGTACTGGGAT
CCGTAGGTTAT -> CGTAGGTTATA
CCGTCCTGAAC -> CGTCCTGAACC
CCGTCTGAGCT -> CGTCTGAGCTC
CCGTGCCGTTG -> CGTGCCGTTGC
CCGTGGAATCA -> CGTGGAATCAG
CCGTGTACGCA -> CGTGTACGCAC
CCGTTGCACCC -> CGTTGCACCCC
CCTAACGACTG -> CTAACGACTGA
CCTAACTTTAC -> CTAACTTTACC
CCTAATTGGCC -> CTAATTGGCCT
CCTACACTGAG -> CTACACTGAGC
CCTAGAGTGTC -> CTAGAGTGTCA
CCTAGTAGCTA -> CTAGTAGCTAA
CCTCACCATGC -> CTCACCATGCT
CCTCGACGCGC -> CTCGACGCGCT
CCTCGAGTGAG -> CTCGAGTGAGC
CCTCGCTTCAT -> CTCGCTTCATG
CCTCGTGGCCC -> CTCGTGGCCCT
CCTCGTTCGAA -> CTCGTTCGAAA
CCTCTGATTGT -> CTCTGATTGTC
CCTCTTGGAAA -> CTCTTGGAAAA
CCTGAACCGAA -> CTGAACCGAAC
CCTGACGTGCG -> CTGACGTGCGG
CCTGCCAGCCT -> CTGCCAGCCTC
CCTGCTGAGGT -> CTGCTGAGGTG
CCTGGCAACTA -> CTGGCAACTAG
CCTGGCGTTTG -> CTGGCGTTTGG
CCTTAGGAACT -> CTTAGGAACTA
CCTTATGTTGC -> CTTATGTTGCT
CCTTCCGACTG -> CTTCCGACTGG
CCTTCCGATTA -> CTTCCGATTAT
CCTTCCGATTC -> CTTCCGATTCC
CCTTCCGCATT -> CTTCCGCATTT
CCTTTCACTCC -> CTTTCACTCCG
CCTTTGCAACT -> CTTTGCAACTG
CCTTTGGAGCT -> CTTTGGAGCTG
CCTTTTATGAA -> CTTTTATGAAG
CGAAAATGATT -> GAAAATGATTG
CGAAACGGCTT -> GAAACGGCTTT
CGAACCAGAGC -> GAACCAGAGCT
CGAAGGAATCA -> GAAGGAATCAC
CGAATATGGAA -> GAATATGGAAG
CGAATCCATAC -> GAATCCATACG
CGAATTGTTAT -> GAATTGTTATG
CGACAATGGGC -> GACAATGGGCG
CGACACGCGGA -> GACACGCGGAT
CGACAGGTATC -> GACAGGTATCG
CGACCACGGAG -> GACCACGGAGT
CGACCGCTCGT -> GACCGCTCGTG
CGACGAATCCA -> GACGAATCCAT
CGACGCGCTGT -> GACGCGCTGTT
CGACGTGACCT -> GACGTGACCTG
CGACTGACGTG -> GACTGACGTGG
CGACTGGAATG -> GACTGGAATGC
CGACTGGGGTG -> GACTGGGGTGT
CGAGAAACGAT -> GAGAAACGATT
CGAGAAACTGT -> GAGAAACTGTA
CGAGACCGATG -> GAGACCGATGG
CGAGAGTCTAT -> GAGAGTCTATT
CGAGCCGCATA -> GAGCCGCATAG
CGAGGGTTTGA -> GAGGGTTTGAG
CGAGGTAGGAC -> GAGGTAGGACG
CGAGGTGATCT -> GAGGTGATCTG
CGAGTCACACC -> GAGTCACACCG
CGAGTGAGCCA -> GAGTGAGCCAG
CGATCCGTGGA -> GATCCGTGGAA
CGATCTACGTA -> GATCTACGTAT
CGATGGGGGAC -> GATGGGGGACC
CGATGTGCAAG -> GATGTGCAAGT
CGATTATGTAC -> GATTATGTACA
CGATTCCCTTC -> GATTCCCTTCC
CGATTCCGCAA -> GATTCCGCAAC
CGATTGGGTGA -> GATTGGGTGAG
CGCAACATCAG -> GCAACATCAGC
CGCAAGACAAG -> GCAAGACAAGA
CGCACCCTTTG -> GCACCCTTTGC
CGCACGGAGAG -> GCACGGAGAGA
CGCACTAACCA -> GCACTAACCAC
CGCACTTAGGT -> GCACTTAGGTC
CGCACTTTCGC -> GCACTTTCGCG
CGCAGGCGTAG -> GCAGGCGTAGT
CGCATAGGTAG -> GCATAGGTAGC
CGCATTTCTTA -> GCATTTCTTAA
CGCCAAGGCTG -> GCCAAGGCTGA
CGCCATAATGA -> GCCATAATGAG
CGCCGCTCAAG -> GCCGCTCAAGT
CGCCGTGCCGT -> GCCGTGCCGTT
CGCCTCGTGGC -> GCCTCGTGGCC
CGCCTTATGTT -> GCCTTATGTTG
CGCGCGGAAGA -> GCGCGGAAGAC
CGCGCTGTTCT -> GCGCTGTTCTA
CGCGGAAGACA -> GCGGAAGACAG
CGCGGATTGAG -> GCGGATTGAGC
CGCGGCAACAG -> GCGGCAACAGA
CGCGGCCAAAA -> GCGGCCAAAAG
CGCGGCCGAGA -> GCGGCCGAGAG
CGCGTGTAGAT -> GCGTGTAGATA
CGCGTTAACTG -> GCGTTAACTGA
CGCTATAACAC -> GCTATAACACT
CGCTCAAGTCT -> GCTCAAGTCTA
CGCTCCGGGTT -> GCTCCGGGTTC
CGCTCGAAACG -> GCTCGAAACGG
CGCTCGCACGG -> GCTCGCACGGA
CGCTCGGTGCA -> GCTCGGTGCAC
CGCTCGTGTAA -> GCTCGTGTAAT
CGCTGTTCTAC -> GCTGTTCTACC
CGCTTCATGGG -> GCTTCATGGGG
CGCTTTAGAGG -> GCTTTAGAGGC
CGGAACGCACT -> GGAACGCACTA
CGGAAGACAGC -> GGAAGACAGCT
CGGACGAATAT -> GGACGAATATG
CGGAGAGAGCG -> GGAGAGAGCGG
CGGAGATTAGT -> GGAGATTAGTG
CGGAGCAGCAG -> GGAGCAGCAGT
CGGAGCTCTTT -> GGAGCTCTTTC
CGGAGTTGTCG -> GGAGTTGTCGA
CGGATCTGGGG -> GGATCTGGGGT
CGGATTGAGCA -> GGATTGAGCAC
CGGCAACAGAG -> GGCAACAGAGC
CGGCACCCACG -> GGCACCCACGG
CGGCACGCAAG -> GGCACGCAAGA
CGGCCAAAAGA -> GGCCAAAAGAA
CGGCCCTCGCT -> GGCCCTCGCTT
CGGCCGAGAGT -> GGCCGAGAGTC
CGGCCTTAGGA -> GGCCTTAGGAA
CGGCGTCCTAA -> GGCGTCCTAAT
CGGCTGGCATC -> GGCTGGCATCG
CGGCTTTCACC -> GGCTTTCACCC
CGGCTTTGGTG -> GGCTTTGGTGG
CGGGAAATCAA -> GGGAAATCAAA
CGGGCCAACAT -> GGGCCAACATT
CGGGCGGGCCA -> GGGCGGGCCAA
CGGGTTCCCAA -> GGGTTCCCAAC
CGGTATATCGA -> GGTATATCGAG
CGGTCCCGTAC -> GGTCCCGTACC
CGGTGCACCGA -> GGTGCACCGAT
CGGTTGCAAAC -> GGTTGCAAACC
CGGTTGGACCG -> GGTTGGACCGC
CGTAATTTCCT -> GTAATTTCCTC
CGTACCTAACT -> GTACCTAACTT
CGTACCTAGAG -> GTACCTAGAGT
CGTACTGGGAT -> GTACTGGGATG
CGTAGACTAGC -> GTAGACTAGCT
CGTAGGTTATA -> GTAGGTTATAT
CGTAGTTTAGA -> GTAGTTTAGAG
CGTATTATCGC -> GTATTATCGCC
CGTCACGGAGA -> GTCACGGAGAT
CGTCCTAATTG -> GTCCTAATTGG
CGTCCTGAACC -> GTCCTGAACCG
CGTCTGAGCTC -> GTCTGAGCTCT
CGTGACAGAAT -> GTGACAGAATC
CGTGACCTGCT -> GTGACCTGCTG
CGTGCCGTTGC -> GTGCCGTTGCA
CGTGCGGAGCA -> GTGCGGAGCAG
CGTGGAATCAG -> GTGGAATCAGT
CGTGGCCCTCA -> GTGGCCCTCAC
CGTGGTAAGTA -> GTGGTAAGTAT
CGTGTAATAAC -> GTGTAATAACT
CGTGTACGCAC -> GTGTACGCACC
CGTGTAGATAC -> GTGTAGATACA
CGTGTTAGACG -> GTGTTAGACGG
CGTGTTATTGC -> GTGTTATTGCT
CGTTAACTGAT -> GTTAACTGATG
CGTTCGAAAAT -> GTTCGAAAATG
CGTTCGGTCCC -> GTTCGGTCCCG
CGTTGCACCCC -> GTTGCACCCCT
CGTTTGGCACT -> GTTTGGCACTC
CTAAATTTTTT -> TAAATTTTTTA
CTAACCACTAC -> TAACCACTACG
CTAACGACTGA -> TAACGACTGAC
CTAACGAGGTG -> TAACGAGGTGA
CTAACTTTACC -> TAACTTTACCT
CTAAGGCTCGA -> TAAGGCTCGAT
CTAAGGGAACA -> TAAGGGAACAC
CTAATCCGAGA -> TAATCCGAGAC
CTAATTGGCCT -> TAATTGGCCTT
CTACACTGAGC -> TACACTGAGCC
CTACATGAGTA -> TACATGAGTAT
CTACCTTTCAC -> TACCTTTCACT
CTACGAGTCAC -> TACGAGTCACA
CTACGTATTAT -> TACGTATTATC
CTAGAGTGTCA -> TAGAGTGTCAA
CTAGCCCTTTG -> TAGCCCTTTGG
CTAGCTCCAAG -> TAGCTCCAAGA
CTAGGCTGGGG -> TAGGCTGGGGA
CTAGTAGCTAA -> TAGTAGCTAAC
CTATAACACTT -> TATAACACTTA
CTATACTTCCT -> TATACTTCCTC
CTATCTCAACG -> TATCTCAACGC
CTATGAGGACA -> TATGAGGACAG
CTATTAGCAAA -> TATTAGCAAAA
CTATTGGCGGC -> TATTGGCGGCT
CTATTTAACAT -> TATTTAACATT
CTATTTAATCG -> TATTTAATCGA
CTCAACGCGCG -> TCAACGCGCGG
CTCAAGATGTA -> TCAAGATGTAG
CTCAAGTCTAT -> TCAAGTCTATT
CTCACCATGCT -> TCACCATGCTA
CTCAGGTTGAT -> TCAGGTTGATG
CTCATTAAAAT -> TCATTAAAATA
CTCCAAGACCA -> TCCAAGACCAA
CTCCAGTATCA -> TCCAGTATCAA
CTCCGCCTCGT -> TCCGCCTCGTG
CTCCGGGTTCC -> TCCGGGTTCCC
CTCCTGCCAGC -> TCCTGCCAGCC
CTCGAAACGGC -> TCGAAACGGCT
CTCGACGCGCT -> TCGACGCGCTG
CTCGAGAAACT -> TCGAGAAACTG
CTCGAGTGAGC -> TCGAGTGAGCC
CTCGATCTACG -> TCGATCTACGT
CTCGATGTGCA -> TCGATGTGCAA
CTCGCACGGAG -> TCGCACGGAGA
CTCGCTTCATG -> TCGCTTCATGG
CTCGGTGCACC -> TCGGTGCACCG
CTCGTGGCCCT -> TCGTGGCCCTC
CTCGTGTAATA -> TCGTGTAATAA
CTCGTTCGAAA -> TCGTTCGAAAA
CTCTATCTCAA -> TCTATCTCAAC
CTCTGATTGTC -> TCTGATTGTCC
CTCTGGACAAG -> TCTGGACAAGA
CTCTGGCTTTC -> TCTGGCTTTCC
CTCTTGGAAAA -> TCTTGGAAAAG
CTCTTTCAGAC -> TCTTTCAGACA
CTCTTTCCCAG -> TCTTTCCCAGA
CTGAACCGAAC -> TGAACCGAACC
CTGAATCCACA -> TGAATCCACAT
CTGACCATTTC -> TGACCATTTCC
CTGACGGCACC -> TGACGGCACCC
CTGACGTGCGG -> TGACGTGCGGA
CTGACGTGGTA -> TGACGTGGTAA
CTGACTCCTGC -> TGACTCCTGCC
CTGAGCCGAAG -> TGAGCCGAAGG
CTGAGCTCTGG -> TGAGCTCTGGC
CTGAGGTGAGC -> TGAGGTGAGCA
CTGATGAGACC -> TGATGAGACCG
CTGATTGTCCA -> TGATTGTCCAA
CTGCACGCCAA -> TGCACGCCAAG
CTGCCAGCCTC -> TGCCAGCCTCG
CTGCCGACAAT -> TGCCGACAATG
CTGCTGAGGTG -> TGCTGAGGTGA
CTGGAATGCCA -> TGGAATGCCAC
CTGGACAAGAG -> TGGACAAGAGG
CTGGAGTCACC -> TGGAGTCACCT
CTGGCAACTAG -> TGGCAACTAGC
CTGGCATCGCG -> TGGCATCGCGG
CTGGCATTTCT -> TGGCATTTCTC
CTGGCGTTTGG -> TGGCGTTTGGC
CTGGCTGTCGC -> TGGCTGTCGCC
CTGGCTTTCCC -> TGGCTTTCCCA
CTGGGATGCGG -> TGGGATGCGGC
CTGGGGATATT -> TGGGGATATTT
CTGGGGTGTTT -> TGGGGTGTTTG
CTGGGGTTAGG -> TGGGGTTAGGA
CTGTATCCTTC -> TGTATCCTTCC
CTGTCGCCGCT -> TGTCGCCGCTC
CTGTCGTGTTA -> TGTCGTGTTAT
CTGTGGTAACT -> TGTGGTAACTG
CTGTGTTGGTC -> TGTGTTGGTCT
CTGTTCTACCT -> TGTTCTACCTT
CTTAACTGACC -> TTAACTGACCA
CTTAGGAACTA -> TTAGGAACTAA
CTTAGGTCCTG -> TTAGGTCCTGA
CTTAGTCTGCC -> TTAGTCTGCCG
CTTATCTTCCA -> TTATCTTCCAT
CTTATGTTGCT -> TTATGTTGCTA
CTTCAAAACAT -> TTCAAAACATA
CTTCATGGGGT -> TTCATGGGGTC
CTTCCATCCGT -> TTCCATCCGTA
CTTCCGACTGG -> TTCCGACTGGG
CTTCCGATTAT -> TTCCGATTATG
CTTCCGATTCC -> TTCCGATTCCG
CTTCCGCATTT -> TTCCGCATTTC
CTTCCTCGAGT -> TTCCTCGAGTG
CTTCGACTGGA -> TTCGACTGGAA
CTTCTTTAGTT -> TTCTTTAGTTA
CTTGCGCAGGC -> TTGCGCAGGCG
CTTGGAAAAGA -> TTGGAAAAGAT
CTTGGGGCATT -> TTGGGGCATTC
CTTGGTCCCCC -> TTGGTCCCCCA
CTTGTAACGAG -> TTGTAACGAGC
CTTTACCTTTT -> TTTACCTTTTA
CTTTAGAGGCA -> TTTAGAGGCAT
CTTTAGTTACG -> TTTAGTTACGC
CTTTCACCCTT -> TTTCACCCTTC
CTTTCACTCCG -> TTTCACTCCGC
CTTTCAGACAC -> TTTCAGACACG
CTTTCCCACCG -> TTTCCCACCGT
CTTTCCCAGAT -> TTTCCCAGATT
CTTTCGCGTTA -> TTTCGCGTTAA
CTTTGCAACTG -> TTTGCAACTGG
CTTTGGAGCTG -> TTTGGAGCTGC
CTTTGGTGGCG -> TTTGGTGGCGG
CTTTTATGAAG -> TTTTATGAAGA
CTTTTGAATAA -> TTTTGAATAAC
GAAAACCAAAA -> AAAACCAAAAA
GAAAAGATACT -> AAAAGATACTT
GAAAATGATTG -> AAAATGATTGT
GAAACGATTGG -> AAACGATTGGG
GAAACGGCTTT -> AAACGGCTTTC
GAAACTGTATC -> AAACTGTATCC
GAAAGATCTCT -> AAAGATCTCTG
GAAATAGAGCC -> AAATAGAGCCA
GAAATCAAAGC -> AAATCAAAGCT
GAACACCGTGT -> AACACCGTGTA
GAACATGAAAA -> AACATGAAAAC
GAACCAGAGCT -> AACCAGAGCTC
GAACCGAACCA -> AACCGAACCAG
GAACCGTACTG -> AACCGTACTGG
GAACCTCTGAT -> AACCTCTGATT
GAACGCACTAA -> AACGCACTAAC
GAACTAAATTT -> AACTAAATTTT
GAACTTGGGGC -> AACTTGGGGCA
GAAGACAGCTG -> AAGACAGCTGT
GAAGAGCCTAC -> AAGAGCCTACA
GAAGGAATCAC -> AAGGAATCACA
GAAGGAGCGTG -> AAGGAGCGTGA
GAAGGTCTTCA -> AAGGTCTTCAA
GAATAACAGCA -> AATAACAGCAC
GAATATGGAAG -> AATATGGAAGG
GAATCACATTT -> AATCACATTTA
GAATCAGAACT -> AATCAGAACTT
GAATCAGTACA -> AATCAGTACAG
GAATCCACATT -> AATCCACATTG
GAATCCATACG -> AATCCATACGA
GAATGCCACGA -> AATGCCACGAT
GAATTGTTATG -> AATTGTTATGG
GACAAGAGCTC -> ACAAGAGCTCA
GACAAGAGGCT -> ACAAGAGGCTG
GACAATGGGCG -> ACAATGGGCGC
GACACAGAACC -> ACACAGAACCT
GACACCCCTGG -> ACACCCCTGGC
GACACCGACAG -> ACACCGACAGG
GACACGCGGAT -> ACACGCGGATT
GACACGGCGTC -> ACACGGCGTCC
GACACGTTCGG -> ACACGTTCGGT
GACAGAATCAG -> ACAGAATCAGA
GACAGCAATAC -> ACAGCAATACA
GACAGCTGTGT -> ACAGCTGTGTT
GACAGGTATCG -> ACAGGTATCGT
GACCAAAACGC -> ACCAAAACGCG
GACCACCTAGT -> ACCACCTAGTA
GACCACGGAGT -> ACCACGGAGTT
GACCATTTCCA -> ACCATTTCCAT
GACCGATGGGG -> ACCGATGGGGG
GACCGCTATAA -> ACCGCTATAAC
GACCGCTCGTG -> ACCGCTCGTGT
GACCGGTATAT -> ACCGGTATATC
GACCTGCTGAG -> ACCTGCTGAGG
GACGAATATGG -> ACGAATATGGA
GACGAATCCAT -> ACGAATCCATA
GACGACACGCG -> ACGACACGCGG
GACGCGCTGTT -> ACGCGCTGTTC
GACGGCACCCA -> ACGGCACCCAC
GACGGCACGCA -> ACGGCACGCAA
GACGTGACCTG -> ACGTGACCTGC
GACGTGCGGAG -> ACGTGCGGAGC
GACGTGGTAAG -> ACGTGGTAAGT
GACGTGTTAGA -> ACGTGTTAGAC
GACTAGCTCCA -> ACTAGCTCCAA
GACTCCTGCCA -> ACTCCTGCCAG
GACTGACGTGG -> ACTGACGTGGT
GACTGGAATGC -> ACTGGAATGCC
GACTGGGGTGT -> ACTGGGGTGTT
GACTTGTAACG -> ACTTGTAACGA
GAGAAACGATT -> AGAAACGATTG
GAGAAACTGTA -> AGAAACTGTAT
GAGACCGATGG -> AGACCGATGGG
GAGACCGGTAT -> AGACCGGTATA
GAGAGAGCGGG -> AGAGAGCGGGA
GAGAGCGGGAA -> AGAGCGGGAAA
GAGAGCTATAC -> AGAGCTATACT
GAGAGTCTATT -> AGAGTCTATTA
GAGATTAGTGA -> AGATTAGTGAC
GAGCACGCCAT -> AGCACGCCATA
GAGCAGCAGTT -> AGCAGCAGTTG
GAGCATAAGTG -> AGCATAAGTGG
GAGCCAGACAC -> AGCCAGACACG
GAGCCAGGCAG -> AGCCAGGCAGC
GAGCCGAAGGA -> AGCCGAAGGAA
GAGCCGCATAG -> AGCCGCATAGG
GAGCCGGGCGG -> AGCCGGGCGGG
GAGCCTACACT -> AGCCTACACTG
GAGCGGGAAAT -> AGCGGGAAATC
GAGCGTGACAG -> AGCGTGACAGA
GAGCTATACTT -> AGCTATACTTC
GAGCTCAAGAT -> AGCTCAAGATG
GAGCTCCAGTA -> AGCTCCAGTAT
GAGCTCTGGCT -> AGCTCTGGCTT
GAGCTCTTTCC -> AGCTCTTTCCC
GAGCTGCACGC -> AGCTGCACGCC
GAGGACAGCAA -> AGGACAGCAAT
GAGGCATCGGA -> AGGCATCGGAA
GAGGCTGTCGT -> AGGCTGTCGTG
GAGGGTTTGAG -> AGGGTTTGAGT
GAGGTAGGACG -> AGGTAGGACGA
GAGGTGAGCAT -> AGGTGAGCATA
GAGGTGATCTG -> AGGTGATCTGG
GAGTATTCGAC -> AGTATTCGACG
GAGTCACACCG -> AGTCACACCGT
GAGTCACCTCG -> AGTCACCTCGA
GAGTCGCTCGA -> AGTCGCTCGAA
GAGTCTATTAG -> AGTCTATTAGC
GAGTGAGCCAG -> AGTGAGCCAGG
GAGTGTACGAA -> AGTGTACGAAT
GAGTGTCAACT -> AGTGTCAACTC
GAGTTCTTCGA -> AGTTCTTCGAC
GAGTTGTCGAC -> AGTTGTCGACC
GAGTTTTCTAT -> AGTTTTCTATT
GATACACTAGG -> ATACACTAGGC
GATACTTGGTC -> ATACTTGGTCC
GATATTTGTCG -> ATATTTGTCGC
GATCCGTGGAA -> ATCCGTGGAAT
GATCGGCCTTA -> ATCGGCCTTAG
GATCGTAGACT -> ATCGTAGACTA
GATCTACGTAT -> ATCTACGTATT
GATCTCTGGAC -> ATCTCTGGACA
GATCTGACGGC -> ATCTGACGGCA
GATCTGGAGTC -> ATCTGGAGTCA
GATCTGGGGTT -> ATCTGGGGTTA
GATGAGACCGG -> ATGAGACCGGT
GATGCGGCTTT -> ATGCGGCTTTG
GATGGGGGACC -> ATGGGGGACCA
GATGTAGCATC -> ATGTAGCATCA
GATGTAGGCTT -> ATGTAGGCTTT
GATGTGCAAGT -> ATGTGCAAGTT
GATTAAGAAGG -> ATTAAGAAGGA
GATTAGTGACG -> ATTAGTGACGT
GATTATGTACA -> ATTATGTACAC
GATTCCCTTCC -> ATTCCCTTCCG
GATTCCGCAAC -> ATTCCGCAACA
GATTGAAATAG -> ATTGAAATAGA
GATTGAGCACG -> ATTGAGCACGC
GATTGGGTGAG -> ATTGGGTGAGA
GATTGTCCAAC -> ATTGTCCAACA
GATTGTCGAGG -> ATTGTCGAGGG
GCAAAATAATG -> CAAAATAATGA
GCAAACCGTAG -> CAAACCGTAGG
GCAACAGAGCC -> CAACAGAGCCG
GCAACATCAGC -> CAACATCAGCC
GCAACGGCCCT -> CAACGGCCCTC
GCAACTAGCCC -> CAACTAGCCCT
GCAACTGGCAT -> CAACTGGCATT
GCAAGACAAGA -> CAAGACAAGAG
GCAAGTTAGCC -> CAAGTTAGCCG
GCAATACACTC -> CAATACACTCG
GCACATGACAC -> CACATGACACC
GCACCCACGGA -> CACCCACGGAG
GCACCCCTGGC -> CACCCCTGGCA
GCACCCTTTGC -> CACCCTTTGCA
GCACCGATTCC -> CACCGATTCCC
GCACGCAAGAC -> CACGCAAGACA
GCACGCCAAGG -> CACGCCAAGGC
GCACGCCATAA -> CACGCCATAAT
GCACGGAGAGA -> CACGGAGAGAG
GCACTAACCAC -> CACTAACCACT
GCACTCATTAA -> CACTCATTAAA
GCACTTAGGTC -> CACTTAGGTCC
GCACTTTCGCG -> CACTTTCGCGT
GCAGCAACGGC -> CAGCAACGGCC
GCAGCAGTTGC -> CAGCAGTTGCC
GCAGGCGTAGT -> CAGGCGTAGTT
GCAGTTGCCGA -> CAGTTGCCGAG
GCATAAGTGGC -> CATAAGTGGCC
GCATAGGTAGC -> CATAGGTAGCT
GCATCAACGCA -> CATCAACGCAC
GCATCGCGGCA -> CATCGCGGCAA
GCATCGGAACG -> CATCGGAACGC
GCATCTATGAG -> CATCTATGAGG
GCATTCCCGGA -> CATTCCCGGAC
GCATTTCTCTT -> CATTTCTCTTT
GCATTTCTTAA -> CATTTCTTAAC
GCCAAAAGAAC -> CCAAAAGAACC
GCCAACATTAG -> CCAACATTAGA
GCCAAGGCTGA -> CCAAGGCTGAA
GCCACGATCCG -> CCACGATCCGT
GCCAGACACGG -> CCAGACACGGC
GCCAGCCTCGT -> CCAGCCTCGTT
GCCAGGCAGCA -> CCAGGCAGCAA
GCCAGTAAATG -> CCAGTAAATGC
GCCATAATGAG -> CCATAATGAGT
GCCCCGCGTGT -> CCCCGCGTGTA
GCCCGCTTTAG -> CCCGCTTTAGA
GCCCTCACCAT -> CCCTCACCATG
GCCCTCGCTTC -> CCCTCGCTTCA
GCCCTTTGGAG -> CCCTTTGGAGC
GCCGAAGGAAT -> CCGAAGGAATC
GCCGACAATGG -> CCGACAATGGG
GCCGAGAAACG -> CCGAGAAACGA
GCCGAGAGTCT -> CCGAGAGTCTA
GCCGCATAGGT -> CCGCATAGGTA
GCCGCTCAAGT -> CCGCTCAAGTC
GCCGCTCCGGG -> CCGCTCCGGGT
GCCGGGCGGGC -> CCGGGCGGGCC
GCCGTGCCGTT -> CCGTGCCGTTG
GCCGTTGCACC -> CCGTTGCACCC
GCCTAACGACT -> CCTAACGACTG
GCCTACACTGA -> CCTACACTGAG
GCCTCGTGGCC -> CCTCGTGGCCC
GCCTCGTTCGA -> CCTCGTTCGAA
GCCTTAGGAAC -> CCTTAGGAACT
GCCTTATGTTG -> CCTTATGTTGC
GCCTTCCGCAT -> CCTTCCGCATT
GCGCACTTTCG -> CGCACTTTCGC
GCGCAGGCGTA -> CGCAGGCGTAG
GCGCCTTATGT -> CGCCTTATGTT
GCGCGGAAGAC -> CGCGGAAGACA
GCGCTCGGTGC -> CGCTCGGTGCA
GCGCTGTTCTA -> CGCTGTTCTAC
GCGGAAGACAG -> CGGAAGACAGC
GCGGAGCAGCA -> CGGAGCAGCAG
GCGGATCTGGG -> CGGATCTGGGG
GCGGATTGAGC -> CGGATTGAGCA
GCGGCAACAGA -> CGGCAACAGAG
GCGGCCAAAAG -> CGGCCAAAAGA
GCGGCCGAGAG -> CGGCCGAGAGT
GCGGCTGGCAT -> CGGCTGGCATC
GCGGCTTTGGT -> CGGCTTTGGTG
GCGGGAAATCA -> CGGGAAATCAA
GCGGGCCAACA -> CGGGCCAACAT
GCGGTTGGACC -> CGGTTGGACCG
GCGTAGTTTAG -> CGTAGTTTAGA
GCGTCCTAATT -> CGTCCTAATTG
GCGTGACAGAA -> CGTGACAGAAT
GCGTGTAGATA -> CGTGTAGATAC
GCGTTAACTGA -> CGTTAACTGAT
GCGTTTGGCAC -> CGTTTGGCACT
GCTAACGAGGT -> CTAACGAGGTG
GCTAAGGGAAC -> CTAAGGGAACA
GCTAATCCGAG -> CTAATCCGAGA
GCTACATGAGT -> CTACATGAGTA
GCTATAACACT -> CTATAACACTT
GCTATACTTCC -> CTATACTTCCT
GCTATTGGCGG -> CTATTGGCGGC
GCTCAAGATGT -> CTCAAGATGTA
GCTCAAGTCTA -> CTCAAGTCTAT
GCTCCAAGACC -> CTCCAAGACCA
GCTCCAGTATC -> CTCCAGTATCA
GCTCCGGGTTC -> CTCCGGGTTCC
GCTCGAAACGG -> CTCGAAACGGC
GCTCGATCTAC -> CTCGATCTACG
GCTCGATGTGC -> CTCGATGTGCA
GCTCGCACGGA -> CTCGCACGGAG
GCTCGGTGCAC -> CTCGGTGCACC
GCTCGTGTAAT -> CTCGTGTAATA
GCTCTGGCTTT -> CTCTGGCTTTC
GCTCTTTCCCA -> CTCTTTCCCAG
GCTGAATCCAC -> CTGAATCCACA
GCTGAGGTGAG -> CTGAGGTGAGC
GCTGCACGCCA -> CTGCACGCCAA
GCTGGCATCGC -> CTGGCATCGCG
GCTGGGGATAT -> CTGGGGATATT
GCTGTCGCCGC -> CTGTCGCCGCT
GCTGTCGTGTT -> CTGTCGTGTTA
GCTGTGTTGGT -> CTGTGTTGGTC
GCTGTTCTACC -> CTGTTCTACCT
GCTTATCTTCC -> CTTATCTTCCA
GCTTCATGGGG -> CTTCATGGGGT
GCTTCTTTAGT -> CTTCTTTAGTT
GCTTGCGCAGG -> CTTGCGCAGGC
GCTTTAGAGGC -> CTTTAGAGGCA
GCTTTCACCCT -> CTTTCACCCTT
GCTTTCCCACC -> CTTTCCCACCG
GCTTTGGTGGC -> CTTTGGTGGCG
GCTTTTGAATA -> CTTTTGAATAA
GGAAAAGATAC -> GAAAAGATACT
GGAAATCAAAG -> GAAATCAAAGC
GGAACACCGTG -> GAACACCGTGT
GGAACGCACTA -> GAACGCACTAA
GGAACTAAATT -> GAACTAAATTT
GGAAGACAGCT -> GAAGACAGCTG
GGAAGGTCTTC -> GAAGGTCTTCA
GGAATCACATT -> GAATCACATTT
GGAATCAGTAC -> GAATCAGTACA
GGAATGCCACG -> GAATGCCACGA
GGACAAGAGGC -> GACAAGAGGCT
GGACACAGAAC -> GACACAGAACC
GGACACCCCTG -> GACACCCCTGG
GGACAGCAATA -> GACAGCAATAC
GGACCACCTAG -> GACCACCTAGT
GGACCGCTATA -> GACCGCTATAA
GGACGAATATG -> GACGAATATGG
GGACGACACGC -> GACGACACGCG
GGACTTGTAAC -> GACTTGTAACG
GGAGAGAGCGG -> GAGAGAGCGGG
GGAGATTAGTG -> GAGATTAGTGA
GGAGCAGCAGT -> GAGCAGCAGTT
GGAGCGTGACA -> GAGCGTGACAG
GGAGCTCTTTC -> GAGCTCTTTCC
GGAGCTGCACG -> GAGCTGCACGC
GGAGTCACCTC -> GAGTCACCTCG
GGAGTTGTCGA -> GAGTTGTCGAC
GGATATTTGTC -> GATATTTGTCG
GGATCGGCCTT -> GATCGGCCTTA
GGATCTGGGGT -> GATCTGGGGTT
GGATGCGGCTT -> GATGCGGCTTT
GGATTGAGCAC -> GATTGAGCACG
GGCAACAGAGC -> GCAACAGAGCC
GGCAACTAGCC -> GCAACTAGCCC
GGCACCCACGG -> GCACCCACGGA
GGCACGCAAGA -> GCACGCAAGAC
GGCACTCATTA -> GCACTCATTAA
GGCAGCAACGG -> GCAGCAACGGC
GGCATCGCGGC -> GCATCGCGGCA
GGCATCGGAAC -> GCATCGGAACG
GGCATTCCCGG -> GCATTCCCGGA
GGCATTTCTCT -> GCATTTCTCTT
GGCCAAAAGAA -> GCCAAAAGAAC
GGCCAACATTA -> GCCAACATTAG
GGCCCCGCGTG -> GCCCCGCGTGT
GGCCCTCACCA -> GCCCTCACCAT
GGCCCTCGCTT -> GCCCTCGCTTC
GGCCGAGAGTC -> GCCGAGAGTCT
GGCCTTAGGAA -> GCCTTAGGAAC
GGCCTTCCGCA -> GCCTTCCGCAT
GGCGCCTTATG -> GCGCCTTATGT
GGCGCTCGGTG -> GCGCTCGGTGC
GGCGGATCTGG -> GCGGATCTGGG
GGCGGCTGGCA -> GCGGCTGGCAT
GGCGGGCCAAC -> GCGGGCCAACA
GGCGTAGTTTA -> GCGTAGTTTAG
GGCGTCCTAAT -> GCGTCCTAATT
GGCGTTTGGCA -> GCGTTTGGCAC
GGCTCGATCTA -> GCTCGATCTAC
GGCTGAATCCA -> GCTGAATCCAC
GGCTGGCATCG -> GCTGGCATCGC
GGCTGGGGATA -> GCTGGGGATAT
GGCTGTCGCCG -> GCTGTCGCCGC
GGCTGTCGTGT -> GCTGTCGTGTT
GGCTTGCGCAG -> GCTTGCGCAGG
GGCTTTCACCC -> GCTTTCACCCT
GGCTTTCCCAC -> GCTTTCCCACC
GGCTTTGGTGG -> GCTTTGGTGGC
GGCTTTTGAAT -> GCTTTTGAATA
GGGAAATCAAA -> GGAAATCAAAG
GGGAACACCGT -> GGAACACCGTG
GGGACCACCTA -> GGACCACCTAG
GGGATATTTGT -> GGATATTTGTC
GGGATGCGGCT -> GGATGCGGCTT
GGGCATTCCCG -> GGCATTCCCGG
GGGCCAACATT -> GGCCAACATTA
GGGCGCCTTAT -> GGCGCCTTATG
GGGCGGGCCAA -> GGCGGGCCAAC
GGGCTTGCGCA -> GGCTTGCGCAG
GGGGACCACCT -> GGGACCACCTA
GGGGATATTTG -> GGGATATTTGT
GGGGCATTCCC -> GGGCATTCCCG
GGGGCTTGCGC -> GGGCTTGCGCA
GGGGGACCACC -> GGGGACCACCT
GGGGTCCACGG -> GGGTCCACGGT
GGGGTGTTTGG -> GGGTGTTTGGA
GGGGTTAGGAC -> GGGTTAGGACA
GGGTCCACGGT -> GGTCCACGGTT
GGGTGAGAGCT -> GGTGAGAGCTA
GGGTGTTTGGA -> GGTGTTTGGAT
GGGTTAGGACA -> GGTTAGGACAC
GGGTTCCCAAC -> GGTTCCCAACA
GGGTTTGAGTG -> GGTTTGAGTGT
GGTAACTGGCT -> GTAACTGGCTG
GGTAAGTATCA -> GTAAGTATCAG
GGTAGCTTCTT -> GTAGCTTCTTT
GGTAGGACGAC -> GTAGGACGACA
GGTATATCGAG -> GTATATCGAGG
GGTATCGTCAC -> GTATCGTCACG
GGTCCACGGTT -> GTCCACGGTTG
GGTCCCCCACA -> GTCCCCCACAG
GGTCCCGTACC -> GTCCCGTACCT
GGTCCTGACGT -> GTCCTGACGTG
GGTCTAAGGCT -> GTCTAAGGCTC
GGTCTTCAAAA -> GTCTTCAAAAC
GGTGAGAGCTA -> GTGAGAGCTAT
GGTGAGCATAA -> GTGAGCATAAG
GGTGATCTGAC -> GTGATCTGACG
GGTGATCTGGA -> GTGATCTGGAG
GGTGCACCGAT -> GTGCACCGATT
GGTGGCGGATC -> GTGGCGGATCT
GGTGGTTAACA -> GTGGTTAACAG
GGTGTTTGGAT -> GTGTTTGGATC
GGTTAACAGTG -> GTTAACAGTGG
GGTTAGGACAC -> GTTAGGACACA
GGTTATATGCT -> GTTATATGCTC
GGTTCCCAACA -> GTTCCCAACAT
GGTTGATGTAG -> GTTGATGTAGG
GGTTGCAAACC -> GTTGCAAACCG
GGTTGGACCGC -> GTTGGACCGCT
GGTTTGAGTGT -> GTTTGAGTGTA
GTAAATGCCTA -> TAAATGCCTAA
GTAACGAGCCG -> TAACGAGCCGC
GTAACTGGCTG -> TAACTGGCTGT
GTAAGTATCAG -> TAAGTATCAGA
GTAATAACTCT -> TAATAACTCTA
GTAATTTCCTC -> TAATTTCCTCT
GTACACATGCG -> TACACATGCGC
GTACAGATCGT -> TACAGATCGTA
GTACCTAACTT -> TACCTAACTTT
GTACCTAGAGT -> TACCTAGAGTG
GTACGAATTGT -> TACGAATTGTT
GTACGCACCCT -> TACGCACCCTT
GTACTGGGATG -> TACTGGGATGC
GTAGACTAGCT -> TAGACTAGCTC
GTAGATACACT -> TAGATACACTA
GTAGCATCAAC -> TAGCATCAACG
GTAGCTAACGA -> TAGCTAACGAG
GTAGCTTCTTT -> TAGCTTCTTTA
GTAGGACGACA -> TAGGACGACAC
GTAGGCTTTTG -> TAGGCTTTTGA
GTAGGTTATAT -> TAGGTTATATG
GTAGTGGACTT -> TAGTGGACTTG
GTAGTTTAGAG -> TAGTTTAGAGT
GTATATCGAGG -> TATATCGAGGT
GTATCAATAAT -> TATCAATAATC
GTATCAGAGTT -> TATCAGAGTTC
GTATCCTTCCG -> TATCCTTCCGA
GTATCGTCACG -> TATCGTCACGG
GTATTATCGCC -> TATTATCGCCG
GTATTCGACGT -> TATTCGACGTG
GTCAACTCAGG -> TCAACTCAGGT
GTCACACCGTC -> TCACACCGTCT
GTCACCTCGAC -> TCACCTCGACG
GTCACGGAGAT -> TCACGGAGATT
GTCCAACACCG -> TCCAACACCGT
GTCCACGGTTG -> TCCACGGTTGC
GTCCCCCACAG -> TCCCCCACAGC
GTCCCGTACCT -> TCCCGTACCTA
GTCCTAATTGG -> TCCTAATTGGC
GTCCTGAACCG -> TCCTGAACCGA
GTCCTGACGTG -> TCCTGACGTGC
GTCGACCGCTC -> TCGACCGCTCG
GTCGAGGGTTT -> TCGAGGGTTTG
GTCGCCGCTCA -> TCGCCGCTCAA
GTCGCGGCCAA -> TCGCGGCCAAA
GTCGCTCGAAA -> TCGCTCGAAAC
GTCGTGTTATT -> TCGTGTTATTG
GTCTAAGGCTC -> TCTAAGGCTCG
GTCTATTAGCA -> TCTATTAGCAA
GTCTATTTAAT -> TCTATTTAATC
GTCTGAGCTCT -> TCTGAGCTCTG
GTCTGCCGACA -> TCTGCCGACAA
GTCTGTGGTAA -> TCTGTGGTAAC
GTCTTCAAAAC -> TCTTCAAAACA
GTGACAGAATC -> TGACAGAATCA
GTGACCTGCTG -> TGACCTGCTGA
GTGACGTGTTA -> TGACGTGTTAG
GTGAGAGCTAT -> TGAGAGCTATA
GTGAGCATAAG -> TGAGCATAAGT
GTGAGCCAGGC -> TGAGCCAGGCA
GTGATCTGACG -> TGATCTGACGG
GTGATCTGGAG -> TGATCTGGAGT
GTGCAAGTTAG -> TGCAAGTTAGC
GTGCACCGATT -> TGCACCGATTC
GTGCCGTTGCA -> TGCCGTTGCAC
GTGCGGAGCAG -> TGCGGAGCAGC
GTGGAATCAGT -> TGGAATCAGTA
GTGGACACCCC -> TGGACACCCCT
GTGGACTTGTA -> TGGACTTGTAA
GTGGCCCCGCG -> TGGCCCCGCGT
GTGGCCCTCAC -> TGGCCCTCACC
GTGGCGGATCT -> TGGCGGATCTG
GTGGTAACTGG -> TGGTAACTGGC
GTGGTAAGTAT -> TGGTAAGTATC
GTGGTTAACAG -> TGGTTAACAGT
GTGTAATAACT -> TGTAATAACTC
GTGTACGAATT -> TGTACGAATTG
GTGTACGCACC -> TGTACGCACCC
GTGTAGATACA -> TGTAGATACAC
GTGTCAACTCA -> TGTCAACTCAG
GTGTTAGACGG -> TGTTAGACGGC
GTGTTATTGCT -> TGTTATTGCTA
GTGTTGGTCTA -> TGTTGGTCTAA
GTGTTTGGATC -> TGTTTGGATCG
GTTAACAGTGG -> TTAACAGTGGA
GTTAACTGATG -> TTAACTGATGA
GTTACGCTCGC -> TTACGCTCGCA
GTTAGACGGCA -> TTAGACGGCAC
GTTAGCCGCTC -> TTAGCCGCTCC
GTTAGGACACA -> TTAGGACACAG
GTTATATGCTC -> TTATATGCTCG
GTTATGGCGCT -> TTATGGCGCTC
GTTATTGCTAT -> TTATTGCTATT
GTTCCCAACAT -> TTCCCAACATG
GTTCGAAAATG -> TTCGAAAATGA
GTTCGGTCCCG -> TTCGGTCCCGT
GTTCTACCTTT -> TTCTACCTTTC
GTTCTTCGACT -> TTCTTCGACTG
GTTGATGTAGG -> TTGATGTAGGC
GTTGCAAACCG -> TTGCAAACCGT
GTTGCACCCCT -> TTGCACCCCTG
GTTGCCGAGAA -> TTGCCGAGAAA
GTTGCTACATG -> TTGCTACATGA
GTTGGACCGCT -> TTGGACCGCTA
GTTGGTCTAAG -> TTGGTCTAAGG
GTTGTCGACCG -> TTGTCGACCGC
GTTTAGAGTCG -> TTTAGAGTCGC
GTTTGAGTGTA -> TTTGAGTGTAC
GTTTGGATCGG -> TTTGGATCGGC
GTTTGGCACTC -> TTTGGCACTCA
GTTTTCTATTT -> TTTTCTATTTA
TAAAATATTTA -> AAAATATTTAC
TAAATGCCTAA -> AAATGCCTAAC
TAAATTTTTTA -> AAATTTTTTAA
TAACACTTAGT -> AACACTTAGTC
TAACAGCACAT -> AACAGCACATG
TAACAGTGGAC -> AACAGTGGACA
TAACATTAAGA -> AACATTAAGAA
TAACCACTACG -> AACCACTACGA
TAACGACTGAC -> AACGACTGACG
TAACGAGCCGC -> AACGAGCCGCA
TAACGAGGTGA -> AACGAGGTGAT
TAACTCTATCT -> AACTCTATCTC
TAACTGACCAT -> AACTGACCATT
TAACTGATGAG -> AACTGATGAGA
TAACTGGCTGT -> AACTGGCTGTC
TAACTTTACCT -> AACTTTACCTT
TAAGAACATGA -> AAGAACATGAA
TAAGAAGGAGC -> AAGAAGGAGCG
TAAGGCTCGAT -> AAGGCTCGATC
TAAGGGAACAC -> AAGGGAACACC
TAAGTATCAGA -> AAGTATCAGAG
TAAGTCTGTGG -> AAGTCTGTGGT
TAAGTGGCCCC -> AAGTGGCCCCG
TAATAACTCTA -> AATAACTCTAT
TAATCCGAGAC -> AATCCGAGACC
TAATCGACGAA -> AATCGACGAAT
TAATCTGACTC -> AATCTGACTCC
TAATGAAAGAT -> AATGAAAGATC
TAATGAGTTTT -> AATGAGTTTTC
TAATTCAAGGT -> AATTCAAGGTG
TAATTGGCCTT -> AATTGGCCTTC
TAATTTCCTCT -> AATTTCCTCTT
TACACAGCTTA -> ACACAGCTTAT
TACACATGCGC -> ACACATGCGCA
TACACTAGGCT -> ACACTAGGCTG
TACACTCGAGA -> ACACTCGAGAA
TACACTGAGCC -> ACACTGAGCCG
TACAGATCGTA -> ACAGATCGTAG
TACATGAGTAT -> ACATGAGTATT
TACCTAACTTT -> ACCTAACTTTA
TACCTAGAGTG -> ACCTAGAGTGT
TACCTTTCACT -> ACCTTTCACTC
TACCTTTTATG -> ACCTTTTATGA
TACGAATTGTT -> ACGAATTGTTA
TACGACCACGG -> ACGACCACGGA
TACGAGTCACA -> ACGAGTCACAC
TACGCACCCTT -> ACGCACCCTTT
TACGCTCGCAC -> ACGCTCGCACG
TACGTATTATC -> ACGTATTATCG
TACTGGGATGC -> ACTGGGATGCG
TACTTCCTCGA -> ACTTCCTCGAG
TACTTGGTCCC -> ACTTGGTCCCC
TAGACGGCACG -> AGACGGCACGC
TAGACTAGCTC -> AGACTAGCTCC
TAGAGCCAGAC -> AGAGCCAGACA
TAGAGGCATCG -> AGAGGCATCGG
TAGAGTCGCTC -> AGAGTCGCTCG
TAGAGTGTCAA -> AGAGTGTCAAC
TAGATACACTA -> AGATACACTAG
TAGATTGAAAT -> AGATTGAAATA
TAGCAAAATAA -> AGCAAAATAAT
TAGCATCAACG -> AGCATCAACGC
TAGCCCGCTTT -> AGCCCGCTTTA
TAGCCCTTTGG -> AGCCCTTTGGA
TAGCCGCTCCG -> AGCCGCTCCGG
TAGCTAACGAG -> AGCTAACGAGG
TAGCTCCAAGA -> AGCTCCAAGAC
TAGCTTCTTTA -> AGCTTCTTTAG
TAGGAACTAAA -> AGGAACTAAAT
TAGGACACAGA -> AGGACACAGAA
TAGGACGACAC -> AGGACGACACG
TAGGCTGGGGA -> AGGCTGGGGAT
TAGGCTTTTGA -> AGGCTTTTGAA
TAGGGGCTTGC -> AGGGGCTTGCG
TAGGTAGCTTC -> AGGTAGCTTCT
TAGGTCCTGAC -> AGGTCCTGACG
TAGGTTATATG -> AGGTTATATGC
TAGTAGCTAAC -> AGTAGCTAACG
TAGTCTGCCGA -> AGTCTGCCGAC
TAGTGACGTGT -> AGTGACGTGTT
TAGTGGACTTG -> AGTGGACTTGT
TAGTTACGCTC -> AGTTACGCTCG
TAGTTTAGAGT -> AGTTTAGAGTC
TATAACACTTA -> ATAACACTTAG
TATACTTCCTC -> ATACTTCCTCG
TATATCGAGGT -> ATATCGAGGTA
TATATGCTCGA -> ATATGCTCGAT
TATCAATAATC -> ATCAATAATCT
TATCAGAGTTC -> ATCAGAGTTCT
TATCCTTCCGA -> ATCCTTCCGAC
TATCGAGGTAG -> ATCGAGGTAGG
TATCGCCGTGC -> ATCGCCGTGCC
TATCGTCACGG -> ATCGTCACGGA
TATCTCAACGC -> ATCTCAACGCG
TATCTTCCATC -> ATCTTCCATCC
TATGAAGAGCC -> ATGAAGAGCCT
TATGAGGACAG -> ATGAGGACAGC
TATGCTCGATG -> ATGCTCGATGT
TATGGAAGGTC -> ATGGAAGGTCT
TATGGCGCTCG -> ATGGCGCTCGG
TATGTACACAT -> ATGTACACATG
TATGTTGCTAC -> ATGTTGCTACA
TATTAGCAAAA -> ATTAGCAAAAT
TATTATCGCCG -> ATTATCGCCGT
TATTCGACGTG -> ATTCGACGTGA
TATTGCTATTG -> ATTGCTATTGG
TATTGGCGGCT -> ATTGGCGGCTG
TATTTAACATT -> ATTTAACATTA
TATTTAATCGA -> ATTTAATCGAC
TATTTACACAG -> ATTTACACAGC
TATTTGTCGCG -> ATTTGTCGCGG
TCAAAACATAG -> CAAAACATAGG
TCAAAGCTAAT -> CAAAGCTAATC
TCAACGCACTT -> CAACGCACTTA
TCAACGCGCGG -> CAACGCGCGGA
TCAACTCAGGT -> CAACTCAGGTT
TCAAGATGTAG -> CAAGATGTAGC
TCAAGGTGATC -> CAAGGTGATCT
TCAAGTCTATT -> CAAGTCTATTT
TCAATAATCTG -> CAATAATCTGA
TCACACCGTCT -> CACACCGTCTG
TCACATTTAAG -> CACATTTAAGT
TCACCATGCTA -> CACCATGCTAA
TCACCCTTCCG -> CACCCTTCCGA
TCACCTCGACG -> CACCTCGACGC
TCACGGAGATT -> CACGGAGATTA
TCACTCCGCCT -> CACTCCGCCTC
TCAGAACTTGG -> CAGAACTTGGG
TCAGACACGTT -> CAGACACGTTC
TCAGAGTTCTT -> CAGAGTTCTTC
TCAGCCAGTAA -> CAGCCAGTAAA
TCAGGTTGATG -> CAGGTTGATGT
TCAGTACAGAT -> CAGTACAGATC
TCATGGGGTCC -> CATGGGGTCCA
TCATTAAAATA -> CATTAAAATAT
TCCAACACCGT -> CCAACACCGTC
TCCAAGACCAA -> CCAAGACCAAA
TCCACATTGTA -> CCACATTGTAG
TCCACGGTTGC -> CCACGGTTGCA
TCCAGTATCAA -> CCAGTATCAAT
TCCATACGACC -> CCATACGACCA
TCCATCCGTAA -> CCATCCGTAAT
TCCATTAGCCC -> CCATTAGCCCG
TCCCAACATGC -> CCCAACATGCA
TCCCACCGTAC -> CCCACCGTACC
TCCCAGATTAA -> CCCAGATTAAG
TCCCCCACAGC -> CCCCCACAGCG
TCCCGGACGAA -> CCCGGACGAAT
TCCCGTACCTA -> CCCGTACCTAG
TCCCTTCCGAT -> CCCTTCCGATT
TCCGACTGGGG -> CCGACTGGGGT
TCCGAGACCGA -> CCGAGACCGAT
TCCGATTATGT -> CCGATTATGTA
TCCGATTCCGC -> CCGATTCCGCA
TCCGCAACATC -> CCGCAACATCA
TCCGCATTTCT -> CCGCATTTCTT
TCCGCCTCGTG -> CCGCCTCGTGG
TCCGGGTTCCC -> CCGGGTTCCCA
TCCGTAATTTC -> CCGTAATTTCC
TCCGTGGAATC -> CCGTGGAATCA
TCCTAATTGGC -> CCTAATTGGCC
TCCTCGAGTGA -> CCTCGAGTGAG
TCCTCTTGGAA -> CCTCTTGGAAA
TCCTGAACCGA -> CCTGAACCGAA
TCCTGACGTGC -> CCTGACGTGCG
TCCTGCCAGCC -> CCTGCCAGCCT
TCCTTCCGACT -> CCTTCCGACTG
TCGAAAATGAT -> CGAAAATGATT
TCGAAACGGCT -> CGAAACGGCTT
TCGACCGCTCG -> CGACCGCTCGT
TCGACGAATCC -> CGACGAATCCA
TCGACGCGCTG -> CGACGCGCTGT
TCGACGTGACC -> CGACGTGACCT
TCGACTGGAAT -> CGACTGGAATG
TCGAGAAACTG -> CGAGAAACTGT
TCGAGGGTTTG -> CGAGGGTTTGA
TCGAGGTAGGA -> CGAGGTAGGAC
TCGAGTGAGCC -> CGAGTGAGCCA
TCGATCTACGT -> CGATCTACGTA
TCGATGTGCAA -> CGATGTGCAAG
TCGCACGGAGA -> CGCACGGAGAG
TCGCCGCTCAA -> CGCCGCTCAAG
TCGCCGTGCCG -> CGCCGTGCCGT
TCGCGGCAACA -> CGCGGCAACAG
TCGCGGCCAAA -> CGCGGCCAAAA
TCGCGTTAACT -> CGCGTTAACTG
TCGCTCGAAAC -> CGCTCGAAACG
TCGCTTCATGG -> CGCTTCATGGG
TCGGAACGCAC -> CGGAACGCACT
TCGGCCTTAGG -> CGGCCTTAGGA
TCGGTCCCGTA -> CGGTCCCGTAC
TCGGTGCACCG -> CGGTGCACCGA
TCGTAGACTAG -> CGTAGACTAGC
TCGTCACGGAG -> CGTCACGGAGA
TCGTGGCCCTC -> CGTGGCCCTCA
TCGTGTAATAA -> CGTGTAATAAC
TCGTGTTATTG -> CGTGTTATTGC
TCGTTCGAAAA -> CGTTCGAAAAT
TCTAAGGCTCG -> CTAAGGCTCGA
TCTACCTTTCA -> CTACCTTTCAC
TCTACGTATTA -> CTACGTATTAT
TCTATCTCAAC -> CTATCTCAACG
TCTATGAGGAC -> CTATGAGGACA
TCTATTAGCAA -> CTATTAGCAAA
TCTATTTAACA -> CTATTTAACAT
TCTATTTAATC -> CTATTTAATCG
TCTCAACGCGC -> CTCAACGCGCG
TCTCTGGACAA -> CTCTGGACAAG
TCTCTTTCAGA -> CTCTTTCAGAC
TCTGACGGCAC -> CTGACGGCACC
TCTGACTCCTG -> CTGACTCCTGC
TCTGAGCTCTG -> CTGAGCTCTGG
TCTGATTGTCC -> CTGATTGTCCA
TCTGCCGACAA -> CTGCCGACAAT
TCTGGACAAGA -> CTGGACAAGAG
TCTGGAGTCAC -> CTGGAGTCACC
TCTGGCTTTCC -> CTGGCTTTCCC
TCTGGGGTTAG -> CTGGGGTTAGG
TCTGTGGTAAC -> CTGTGGTAACT
TCTTAACTGAC -> CTTAACTGACC
TCTTCAAAACA -> CTTCAAAACAT
TCTTCCATCCG -> CTTCCATCCGT
TCTTCGACTGG -> CTTCGACTGGA
TCTTGGAAAAG -> CTTGGAAAAGA
TCTTTAGTTAC -> CTTTAGTTACG
TCTTTCAGACA -> CTTTCAGACAC
TCTTTCCCAGA -> CTTTCCCAGAT
TGAAAACCAAA -> GAAAACCAAAA
TGAAAGATCTC -> GAAAGATCTCT
TGAAATAGAGC -> GAAATAGAGCC
TGAACCGAACC -> GAACCGAACCA
TGAAGAGCCTA -> GAAGAGCCTAC
TGAATAACAGC -> GAATAACAGCA
TGAATCCACAT -> GAATCCACATT
TGACACCGACA -> GACACCGACAG
TGACAGAATCA -> GACAGAATCAG
TGACCATTTCC -> GACCATTTCCA
TGACCTGCTGA -> GACCTGCTGAG
TGACGGCACCC -> GACGGCACCCA
TGACGTGCGGA -> GACGTGCGGAG
TGACGTGGTAA -> GACGTGGTAAG
TGACGTGTTAG -> GACGTGTTAGA
TGACTCCTGCC -> GACTCCTGCCA
TGAGACCGGTA -> GAGACCGGTAT
TGAGAGCTATA -> GAGAGCTATAC
TGAGCACGCCA -> GAGCACGCCAT
TGAGCATAAGT -> GAGCATAAGTG
TGAGCCAGGCA -> GAGCCAGGCAG
TGAGCCGAAGG -> GAGCCGAAGGA
TGAGCTCTGGC -> GAGCTCTGGCT
TGAGGACAGCA -> GAGGACAGCAA
TGAGGTGAGCA -> GAGGTGAGCAT
TGAGTATTCGA -> GAGTATTCGAC
TGAGTGTACGA -> GAGTGTACGAA
TGAGTTTTCTA -> GAGTTTTCTAT
TGATCTGACGG -> GATCTGACGGC
TGATCTGGAGT -> GATCTGGAGTC
TGATGAGACCG -> GATGAGACCGG
TGATGTAGGCT -> GATGTAGGCTT
TGATTGTCCAA -> GATTGTCCAAC
TGATTGTCGAG -> GATTGTCGAGG
TGCAAACCGTA -> GCAAACCGTAG
TGCAACTGGCA -> GCAACTGGCAT
TGCAAGTTAGC -> GCAAGTTAGCC
TGCACCCCTGG -> GCACCCCTGGC
TGCACCGATTC -> GCACCGATTCC
TGCACGCCAAG -> GCACGCCAAGG
TGCATCTATGA -> GCATCTATGAG
TGCCACGATCC -> GCCACGATCCG
TGCCAGCCTCG -> GCCAGCCTCGT
TGCCGACAATG -> GCCGACAATGG
TGCCGAGAAAC -> GCCGAGAAACG
TGCCGTTGCAC -> GCCGTTGCACC
TGCCTAACGAC -> GCCTAACGACT
TGCGCACTTTC -> GCGCACTTTCG
TGCGCAGGCGT -> GCGCAGGCGTA
TGCGGAGCAGC -> GCGGAGCAGCA
TGCGGCTTTGG -> GCGGCTTTGGT
TGCTAAGGGAA -> GCTAAGGGAAC
TGCTACATGAG -> GCTACATGAGT
TGCTATTGGCG -> GCTATTGGCGG
TGCTCGATGTG -> GCTCGATGTGC
TGCTGAGGTGA -> GCTGAGGTGAG
TGGAAAAGATA -> GGAAAAGATAC
TGGAAGGTCTT -> GGAAGGTCTTC
TGGAATCAGTA -> GGAATCAGTAC
TGGAATGCCAC -> GGAATGCCACG
TGGACAAGAGG -> GGACAAGAGGC
TGGACACCCCT -> GGACACCCCTG
TGGACCGCTAT -> GGACCGCTATA
TGGACTTGTAA -> GGACTTGTAAC
TGGAGCTGCAC -> GGAGCTGCACG
TGGAGTCACCT -> GGAGTCACCTC
TGGATCGGCCT -> GGATCGGCCTT
TGGCAACTAGC -> GGCAACTAGCC
TGGCACTCATT -> GGCACTCATTA
TGGCATCGCGG -> GGCATCGCGGC
TGGCATTTCTC -> GGCATTTCTCT
TGGCCCCGCGT -> GGCCCCGCGTG
TGGCCCTCACC -> GGCCCTCACCA
TGGCCTTCCGC -> GGCCTTCCGCA
TGGCGCTCGGT -> GGCGCTCGGTG
TGGCGGATCTG -> GGCGGATCTGG
TGGCGGCTGGC -> GGCGGCTGGCA
TGGCGTTTGGC -> GGCGTTTGGCA
TGGCTGTCGCC -> GGCTGTCGCCG
TGGCTTTCCCA -> GGCTTTCCCAC
TGGGATGCGGC -> GGGATGCGGCT
TGGGCGCCTTA -> GGGCGCCTTAT
TGGGGATATTT -> GGGGATATTTG
TGGGGCATTCC -> GGGGCATTCCC
TGGGGGACCAC -> GGGGGACCACC
TGGGGTCCACG -> GGGGTCCACGG
TGGGGTGTTTG -> GGGGTGTTTGG
TGGGGTTAGGA -> GGGGTTAGGAC
TGGGTGAGAGC -> GGGTGAGAGCT
TGGTAACTGGC -> GGTAACTGGCT
TGGTAAGTATC -> GGTAAGTATCA
TGGTCCCCCAC -> GGTCCCCCACA
TGGTCTAAGGC -> GGTCTAAGGCT
TGGTGGCGGAT -> GGTGGCGGATC
TGGTTAACAGT -> GGTTAACAGTG
TGTAACGAGCC -> GTAACGAGCCG
TGTAATAACTC -> GTAATAACTCT
TGTACACATGC -> GTACACATGCG
TGTACGAATTG -> GTACGAATTGT
TGTACGCACCC -> GTACGCACCCT
TGTAGATACAC -> GTAGATACACT
TGTAGCATCAA -> GTAGCATCAAC
TGTAGGCTTTT -> GTAGGCTTTTG
TGTAGTGGACT -> GTAGTGGACTT
TGTATCCTTCC -> GTATCCTTCCG
TGTCAACTCAG -> GTCAACTCAGG
TGTCCAACACC -> GTCCAACACCG
TGTCGACCGCT -> GTCGACCGCTC
TGTCGAGGGTT -> GTCGAGGGTTT
TGTCGCCGCTC -> GTCGCCGCTCA
TGTCGCGGCCA -> GTCGCGGCCAA
TGTCGTGTTAT -> GTCGTGTTATT
TGTGCAAGTTA -> GTGCAAGTTAG
TGTGGTAACTG -> GTGGTAACTGG
TGTGTTGGTCT -> GTGTTGGTCTA
TGTTAGACGGC -> GTTAGACGGCA
TGTTATGGCGC -> GTTATGGCGCT
TGTTATTGCTA -> GTTATTGCTAT
TGTTCTACCTT -> GTTCTACCTTT
TGTTGCTACAT -> GTTGCTACATG
TGTTGGTCTAA -> GTTGGTCTAAG
TGTTTGGATCG -> GTTTGGATCGG
TTAAAATATTT -> TAAAATATTTA
TTAACAGTGGA -> TAACAGTGGAC
TTAACATTAAG -> TAACATTAAGA
TTAACTGACCA -> TAACTGACCAT
TTAACTGATGA -> TAACTGATGAG
TTAAGAACATG -> TAAGAACATGA
TTAAGAAGGAG -> TAAGAAGGAGC
TTAAGTCTGTG -> TAAGTCTGTGG
TTAATCGACGA -> TAATCGACGAA
TTAATTCAAGG -> TAATTCAAGGT
TTACACAGCTT -> TACACAGCTTA
TTACCTTTTAT -> TACCTTTTATG
TTACGCTCGCA -> TACGCTCGCAC
TTAGACGGCAC -> TAGACGGCACG
TTAGAGGCATC -> TAGAGGCATCG
TTAGAGTCGCT -> TAGAGTCGCTC
TTAGATTGAAA -> TAGATTGAAAT
TTAGCAAAATA -> TAGCAAAATAA
TTAGCCCGCTT -> TAGCCCGCTTT
TTAGCCGCTCC -> TAGCCGCTCCG
TTAGGAACTAA -> TAGGAACTAAA
TTAGGACACAG -> TAGGACACAGA
TTAGGTCCTGA -> TAGGTCCTGAC
TTAGTCTGCCG -> TAGTCTGCCGA
TTAGTGACGTG -> TAGTGACGTGT
TTAGTTACGCT -> TAGTTACGCTC
TTATATGCTCG -> TATATGCTCGA
TTATCGCCGTG -> TATCGCCGTGC
TTATCTTCCAT -> TATCTTCCATC
TTATGAAGAGC -> TATGAAGAGCC
TTATGGCGCTC -> TATGGCGCTCG
TTATGTACACA -> TATGTACACAT
TTATGTTGCTA -> TATGTTGCTAC
TTATTGCTATT -> TATTGCTATTG
TTCAAAACATA -> TCAAAACATAG
TTCAAGGTGAT -> TCAAGGTGATC
TTCACCCTTCC -> TCACCCTTCCG
TTCACTCCGCC -> TCACTCCGCCT
TTCAGACACGT -> TCAGACACGTT
TTCATGGGGTC -> TCATGGGGTCC
TTCCATCCGTA -> TCCATCCGTAA
TTCCATTAGCC -> TCCATTAGCCC
TTCCCAACATG -> TCCCAACATGC
TTCCCACCGTA -> TCCCACCGTAC
TTCCCAGATTA -> TCCCAGATTAA
TTCCCGGACGA -> TCCCGGACGAA
TTCCCTTCCGA -> TCCCTTCCGAT
TTCCGACTGGG -> TCCGACTGGGG
TTCCGATTATG -> TCCGATTATGT
TTCCGATTCCG -> TCCGATTCCGC
TTCCGCAACAT -> TCCGCAACATC
TTCCGCATTTC -> TCCGCATTTCT
TTCCTCGAGTG -> TCCTCGAGTGA
TTCCTCTTGGA -> TCCTCTTGGAA
TTCGAAAATGA -> TCGAAAATGAT
TTCGACGTGAC -> TCGACGTGACC
TTCGACTGGAA -> TCGACTGGAAT
TTCGCGTTAAC -> TCGCGTTAACT
TTCGGTCCCGT -> TCGGTCCCGTA
TTCTACCTTTC -> TCTACCTTTCA
TTCTATTTAAC -> TCTATTTAACA
TTCTCTTTCAG -> TCTCTTTCAGA
TTCTTAACTGA -> TCTTAACTGAC
TTCTTCGACTG -> TCTTCGACTGG
TTCTTTAGTTA -> TCTTTAGTTAC
TTGAAATAGAG -> TGAAATAGAGC
TTGAATAACAG -> TGAATAACAGC
TTGAGCACGCC -> TGAGCACGCCA
TTGAGTGTACG -> TGAGTGTACGA
TTGATGTAGGC -> TGATGTAGGCT
TTGCAAACCGT -> TGCAAACCGTA
TTGCAACTGGC -> TGCAACTGGCA
TTGCACCCCTG -> TGCACCCCTGG
TTGCCGAGAAA -> TGCCGAGAAAC
TTGCGCAGGCG -> TGCGCAGGCGT
TTGCTACATGA -> TGCTACATGAG
TTGCTATTGGC -> TGCTATTGGCG
TTGGAAAAGAT -> TGGAAAAGATA
TTGGACCGCTA -> TGGACCGCTAT
TTGGAGCTGCA -> TGGAGCTGCAC
TTGGATCGGCC -> TGGATCGGCCT
TTGGCACTCAT -> TGGCACTCATT
TTGGCCTTCCG -> TGGCCTTCCGC
TTGGCGGCTGG -> TGGCGGCTGGC
TTGGGGCATTC -> TGGGGCATTCC
TTGGGTGAGAG -> TGGGTGAGAGC
TTGGTCCCCCA -> TGGTCCCCCAC
TTGGTCTAAGG -> TGGTCTAAGGC
TTGGTGGCGGA -> TGGTGGCGGAT
TTGTAACGAGC -> TGTAACGAGCC
TTGTAGTGGAC -> TGTAGTGGACT
TTGTCCAACAC -> TGTCCAACACC
TTGTCGACCGC -> TGTCGACCGCT
TTGTCGAGGGT -> TGTCGAGGGTT
TTGTCGCGGCC -> TGTCGCGGCCA
TTGTTATGGCG -> TGTTATGGCGC
TTTAACATTAA -> TTAACATTAAG
TTTAAGTCTGT -> TTAAGTCTGTG
TTTAATCGACG -> TTAATCGACGA
TTTAATTCAAG -> TTAATTCAAGG
TTTACACAGCT -> TTACACAGCTT
TTTACCTTTTA -> TTACCTTTTAT
TTTAGAGGCAT -> TTAGAGGCATC
TTTAGAGTCGC -> TTAGAGTCGCT
TTTAGTTACGC -> TTAGTTACGCT
TTTATGAAGAG -> TTATGAAGAGC
TTTCACCCTTC -> TTCACCCTTCC
TTTCACTCCGC -> TTCACTCCGCC
TTTCAGACACG -> TTCAGACACGT
TTTCCATTAGC -> TTCCATTAGCC
TTTCCCACCGT -> TTCCCACCGTA
TTTCCCAGATT -> TTCCCAGATTA
TTTCCTCTTGG -> TTCCTCTTGGA
TTTCGCGTTAA -> TTCGCGTTAAC
TTTCTATTTAA -> TTCTATTTAAC
TTTCTCTTTCA -> TTCTCTTTCAG
TTTCTTAACTG -> TTCTTAACTGA
TTTGAATAACA -> TTGAATAACAG
TTTGAGTGTAC -> TTGAGTGTACG
TTTGCAACTGG -> TTGCAACTGGC
TTTGGAGCTGC -> TTGGAGCTGCA
TTTGGATCGGC -> TTGGATCGGCC
TTTGGCACTCA -> TTGGCACTCAT
TTTGGTGGCGG -> TTGGTGGCGGA
TTTGTCGCGGC -> TTGTCGCGGCC
TTTTAATTCAA -> TTTAATTCAAG
TTTTATGAAGA -> TTTATGAAGAG
TTTTCTATTTA -> TTTCTATTTAA
TTTTGAATAAC -> TTTGAATAACA
TTTTTAATTCA -> TTTTAATTCAA
TTTTTTAATTC -> TTTTTAATTCA