AAAAACAGGCTACTCAGAA -> AAAACAGGCTACTCAGAAA
AAAAACATTGTATGCTCAT -> AAAACATTGTATGCTCATC
AAAACAGGCTACTCAGAAA -> AAACAGGCTACTCAGAAAC
AAAACATTGTATGCTCATC -> AAACATTGTATGCTCATCC
AAAACTCTTGCTTGCCCAG -> AAACTCTTGCTTGCCCAGG
AAAACTTTTTCCCAGGGTT -> AAACTTTTTCCCAGGGTTC
AAACACGACTCCAAATCAA -> AACACGACTCCAAATCAAA
AAACAGAAGAGTTCTTATT -> AACAGAAGAGTTCTTATTA
AAACAGGCTACTCAGAAAC -> AACAGGCTACTCAGAAACG
AAACAGGTGCCCGTTCTGT -> AACAGGTGCCCGTTCTGTA
AAACATTGTATGCTCATCC -> AACATTGTATGCTCATCCG
AAACCCCGGGAAAGGTGAA -> AACCCCGGGAAAGGTGAAT
AAACGACTACCCTTCCGCG -> AACGACTACCCTTCCGCGA
AAACGCCGGGACTCTCTGA -> AACGCCGGGACTCTCTGAG
AAACGGAACTGGCGAGCCC -> AACGGAACTGGCGAGCCCA
AAACGTCGGGTCCGGACTA -> AACGTCGGGTCCGGACTAT
AAACTAAAGGGTTGAAGAC -> AACTAAAGGGTTGAAGACA
AAACTCTTGCTTGCCCAGG -> AACTCTTGCTTGCCCAGGG
AAACTGTAGACATGAGATG -> AACTGTAGACATGAGATGG
AAACTTTTTCCCAGGGTTC -> AACTTTTTCCCAGGGTTCG
AAAGCACTGTAATCTGGCC -> AAGCACTGTAATCTGGCCG
AAAGGGTTGAAGACAGTAA -> AAGGGTTGAAGACAGTAAG
AAAGGTGAATTCTCGGGCT -> AAGGTGAATTCTCGGGCTA
AAATATTCCACCCTACAGT -> AATATTCCACCCTACAGTT
AAATATTCCGTTATCATCT -> AATATTCCGTTATCATCTG
AAATCAAAACTCTTGCTTG -> AATCAAAACTCTTGCTTGC
AAATCACTAAATGCCTGCC -> AATCACTAAATGCCTGCCG
AAATCGGCTGTCCCCACTT -> AATCGGCTGTCCCCACTTT
AAATGCCTGCCGCGAAATG -> AATGCCTGCCGCGAAATGC
AAATGCCTGCCGCGAATTT -> AATGCCTGCCGCGAATTTT
AAATGCCTGCCGCGACCAA -> AATGCCTGCCGCGACCAAT
AAATGCCTGCCGCGATAGG -> AATGCCTGCCGCGATAGGT
AAATGGATGTACCTCAAGA -> AATGGATGTACCTCAAGAC
AAATGTGTATTACGTAGGT -> AATGTGTATTACGTAGGTG
AAATTCCTCATGCAGTTTG -> AATTCCTCATGCAGTTTGC
AAATTCCTCTTTCCCCTAA -> AATTCCTCTTTCCCCTAAG
AAATTCGCCTCGTGGTCTG -> AATTCGCCTCGTGGTCTGG
AAATTTCCCGATCCCAGTT -> AATTTCCCGATCCCAGTTA
AACACGAATCTACGTGAAT -> ACACGAATCTACGTGAATA
AACACGACTCCAAATCAAA -> ACACGACTCCAAATCAAAA
AACACTAAATGCCTGCCGC -> ACACTAAATGCCTGCCGCG
AACACTCCTTGAGTCCATG -> ACACTCCTTGAGTCCATGA
AACAGAAGAGTTCTTATTA -> ACAGAAGAGTTCTTATTAC
AACAGCGCTAATAGGACAG -> ACAGCGCTAATAGGACAGA
AACAGGCTACTCAGAAACG -> ACAGGCTACTCAGAAACGG
AACAGGGCCCCGTCAAATT -> ACAGGGCCCCGTCAAATTC
AACAGGTGCCCGTTCTGTA -> ACAGGTGCCCGTTCTGTAG
AACATACCGTGTTTTTCGT -> ACATACCGTGTTTTTCGTC
AACATTGTATGCTCATCCG -> ACATTGTATGCTCATCCGA
AACCAAACTGTAGACATGA -> ACCAAACTGTAGACATGAG
AACCATTATGGCGTGCTGA -> ACCATTATGGCGTGCTGAT
AACCCCGGGAAAGGTGAAT -> ACCCCGGGAAAGGTGAATT
AACCGAGACTTACGATATT -> ACCGAGACTTACGATATTC
AACCGGTCGTGATCAAAAA -> ACCGGTCGTGATCAAAAAC
AACCGTTTGGATGCTTGCG -> ACCGTTTGGATGCTTGCGT
AACCTTAAGCACCCTCAGC -> ACCTTAAGCACCCTCAGCC
AACCTTGGTGTTTGCGACG -> ACCTTGGTGTTTGCGACGG
AACGAAGGCAAATTCGCCT -> ACGAAGGCAAATTCGCCTC
AACGACTACCCTTCCGCGA -> ACGACTACCCTTCCGCGAA
AACGATAACGCGAGCGCAT -> ACGATAACGCGAGCGCATG
AACGCCGAAGTACTGTTGG -> ACGCCGAAGTACTGTTGGT
AACGCCGGGACTCTCTGAG -> ACGCCGGGACTCTCTGAGC
AACGCGAGCGCATGTAGAA -> ACGCGAGCGCATGTAGAAG
AACGGAACTGGCGAGCCCA -> ACGGAACTGGCGAGCCCAT
AACGGCGTAGGCCTTAGGC -> ACGGCGTAGGCCTTAGGCT
AACGGTCCGGGAATACCAG -> ACGGTCCGGGAATACCAGT
AACGTCGGGTCCGGACTAT -> ACGTCGGGTCCGGACTATC
AACGTTGCCTACGACGATC -> ACGTTGCCTACGACGATCC
AACTAAAGGGTTGAAGACA -> ACTAAAGGGTTGAAGACAG
AACTATTGTATGATCGGGC -> ACTATTGTATGATCGGGCG
AACTCGCCGTGAGCAATTT -> ACTCGCCGTGAGCAATTTA
AACTCTTAGCTAACGTTGC -> ACTCTTAGCTAACGTTGCC
AACTCTTGAAATATTCCGT -> ACTCTTGAAATATTCCGTT
AACTCTTGCTTGCCCAGGG -> ACTCTTGCTTGCCCAGGGG
AACTGGCGAGCCCATCACC -> ACTGGCGAGCCCATCACCG
AACTGTAGACATGAGATGG -> ACTGTAGACATGAGATGGT
AACTTTTTCCCAGGGTTCG -> ACTTTTTCCCAGGGTTCGC
AACTTTTTTCGCCTATGCC -> ACTTTTTTCGCCTATGCCT
AAGAAATTCCTCATGCAGT -> AGAAATTCCTCATGCAGTT
AAGAACGGTCCGGGAATAC -> AGAACGGTCCGGGAATACC
AAGACAGTAAGTCAGTTCA -> AGACAGTAAGTCAGTTCAG
AAGACTGTGGAGCACGGAC -> AGACTGTGGAGCACGGACG
AAGACTTGGGTCCTTAATC -> AGACTTGGGTCCTTAATCG
AAGAGTTCTTATTACTAAA -> AGAGTTCTTATTACTAAAC
AAGCAACTCTTGAAATATT -> AGCAACTCTTGAAATATTC
AAGCACCCTCAGCCCAACG -> AGCACCCTCAGCCCAACGA
AAGCACTGTAATCTGGCCG -> AGCACTGTAATCTGGCCGG
AAGCAGTCTCAAACCCCGG -> AGCAGTCTCAAACCCCGGG
AAGCATGTTTGGCCCTGGG -> AGCATGTTTGGCCCTGGGG
AAGCCCGCTACGAATGACG -> AGCCCGCTACGAATGACGA
AAGGAAGAAATTCCTCATG -> AGGAAGAAATTCCTCATGC
AAGGATGCAGCAACACGAA -> AGGATGCAGCAACACGAAT
AAGGCAAATTCGCCTCGTG -> AGGCAAATTCGCCTCGTGG
AAGGCAGTATGGACGCATA -> AGGCAGTATGGACGCATAG
AAGGCGGTACAACAGCGCT -> AGGCGGTACAACAGCGCTA
AAGGGTTGAAGACAGTAAG -> AGGGTTGAAGACAGTAAGT
AAGGTGAATTCTCGGGCTA -> AGGTGAATTCTCGGGCTAA
AAGGTTCCCGTATCTGGCC -> AGGTTCCCGTATCTGGCCG
AAGGTTCGGCACTGGCATC -> AGGTTCGGCACTGGCATCC
AAGTACGGGAACCTTGGTG -> AGTACGGGAACCTTGGTGT
AAGTACTGTTGGTCGCGAT -> AGTACTGTTGGTCGCGATG
AAGTCAGTTCAGTGCAAAC -> AGTCAGTTCAGTGCAAACA
AAGTTACCAAATATTCCAC -> AGTTACCAAATATTCCACC
AATACCACAACTTTTTTCG -> ATACCACAACTTTTTTCGC
AATACCAGTTTTCAATGGA -> ATACCAGTTTTCAATGGAT
AATACCTCACGTGTGCGTT -> ATACCTCACGTGTGCGTTT
AATAGCTGTTGGCTTGGTT -> ATAGCTGTTGGCTTGGTTC
AATAGGACAGACATTGTGG -> ATAGGACAGACATTGTGGC
AATATTCCACCCTACAGTT -> ATATTCCACCCTACAGTTT
AATATTCCGTTATCATCTG -> ATATTCCGTTATCATCTGG
AATCAAAACTCTTGCTTGC -> ATCAAAACTCTTGCTTGCC
AATCACTAAATGCCTGCCG -> ATCACTAAATGCCTGCCGC
AATCCCTTTAGCTGAGTCT -> ATCCCTTTAGCTGAGTCTT
AATCGCACGCGTAAGGCAG -> ATCGCACGCGTAAGGCAGT
AATCGGCTGTCCCCACTTT -> ATCGGCTGTCCCCACTTTT
AATCTACGTGAATAGCTGT -> ATCTACGTGAATAGCTGTT
AATCTGGCCGGGCGCCAGT -> ATCTGGCCGGGCGCCAGTA
AATGACGACGGCTCGGCCG -> ATGACGACGGCTCGGCCGA
AATGCCTGCCGCGAAATGC -> ATGCCTGCCGCGAAATGCC
AATGCCTGCCGCGAATTTT -> ATGCCTGCCGCGAATTTTC
AATGCCTGCCGCGACCAAT -> ATGCCTGCCGCGACCAATT
AATGCCTGCCGCGATAGGT -> ATGCCTGCCGCGATAGGTC
AATGGATGGTTTACGCGAA -> ATGGATGGTTTACGCGAAC
AATGGATGTACCTCAAGAC -> ATGGATGTACCTCAAGACT
AATGTGTATTACGTAGGTG -> ATGTGTATTACGTAGGTGA
AATTAATCCCTTTAGCTGA -> ATTAATCCCTTTAGCTGAG
AATTATATCAGGCTTTCAA -> ATTATATCAGGCTTTCAAG
AATTCCTCATGCAGTTTGC -> ATTCCTCATGCAGTTTGCA
AATTCCTCTTTCCCCTAAG -> ATTCCTCTTTCCCCTAAGC
AATTCGCCTCGTGGTCTGG -> ATTCGCCTCGTGGTCTGGC
AATTCTCGGGCTAACCAAA -> ATTCTCGGGCTAACCAAAC
AATTGATCGGACTGCCGTG -> ATTGATCGGACTGCCGTGT
AATTGTAAGCCCGCTACGA -> ATTGTAAGCCCGCTACGAA
AATTTCCCGATCCCAGTTA -> ATTTCCCGATCCCAGTTAG
AATTTTCAAGGTTCCCGTA -> ATTTTCAAGGTTCCCGTAT
ACAAATCACTAAATGCCTG -> CAAATCACTAAATGCCTGC
ACAACAGCGCTAATAGGAC -> CAACAGCGCTAATAGGACA
ACAACTTTTTTCGCCTATG -> CAACTTTTTTCGCCTATGC
ACAAGGTTCGGCACTGGCA -> CAAGGTTCGGCACTGGCAT
ACAATACCTCACGTGTGCG -> CAATACCTCACGTGTGCGT
ACAATTATATCAGGCTTTC -> CAATTATATCAGGCTTTCA
ACACGAATCTACGTGAATA -> CACGAATCTACGTGAATAG
ACACGACTCCAAATCAAAA -> CACGACTCCAAATCAAAAC
ACACGGATGAGATATCGCT -> CACGGATGAGATATCGCTT
ACACTAAATGCCTGCCGCG -> CACTAAATGCCTGCCGCGA,CACTAAATGCCTGCCGCGA
ACACTCCTTGAGTCCATGA -> CACTCCTTGAGTCCATGAT
ACAGAAGAGTTCTTATTAC -> CAGAAGAGTTCTTATTACT
ACAGACATTGTGGCTTGTT -> CAGACATTGTGGCTTGTTC
ACAGCGCTAATAGGACAGA -> CAGCGCTAATAGGACAGAC
ACAGGCTACTCAGAAACGG -> CAGGCTACTCAGAAACGGA
ACAGGGCCCCGTCAAATTC -> CAGGGCCCCGTCAAATTCC
ACAGGTGCCCGTTCTGTAG -> CAGGTGCCCGTTCTGTAGA
ACAGTAAGTCAGTTCAGTG -> CAGTAAGTCAGTTCAGTGC
ACAGTTGAAACTAAAGGGT -> CAGTTGAAACTAAAGGGTT
ACAGTTTCTAACGGCGTAG -> CAGTTTCTAACGGCGTAGG
ACATACCGTGTTTTTCGTC -> CATACCGTGTTTTTCGTCC
ACATGAGATGGTAACTCTT -> CATGAGATGGTAACTCTTA
ACATTGTATGCTCATCCGA -> CATTGTATGCTCATCCGAT
ACATTGTGGCTTGTTCAGG -> CATTGTGGCTTGTTCAGGT
ACCAAACTGTAGACATGAG -> CCAAACTGTAGACATGAGA
ACCAAATATTCCACCCTAC -> CCAAATATTCCACCCTACA
ACCAACACTCCTTGAGTCC -> CCAACACTCCTTGAGTCCA
ACCAATTGATCGGACTGCC -> CCAATTGATCGGACTGCCG
ACCAATTGTAAGCCCGCTA -> CCAATTGTAAGCCCGCTAC
ACCACAACTTTTTTCGCCT -> CCACAACTTTTTTCGCCTA
ACCAGTTTTCAATGGATGG -> CCAGTTTTCAATGGATGGT
ACCATGGCGCTTTGCCAAT -> CCATGGCGCTTTGCCAATA
ACCATTATGGCGTGCTGAT -> CCATTATGGCGTGCTGATG
ACCCCGGGAAAGGTGAATT -> CCCCGGGAAAGGTGAATTC
ACCCTACAGTTTCTAACGG -> CCCTACAGTTTCTAACGGC
ACCCTCAGCCCAACGATAA -> CCCTCAGCCCAACGATAAC
ACCCTTCCGCGAAACAGAA -> CCCTTCCGCGAAACAGAAG
ACCGAATTAATCCCTTTAG -> CCGAATTAATCCCTTTAGC
ACCGAGACTTACGATATTC -> CCGAGACTTACGATATTCC
ACCGATGGGTAGAAAAACA -> CCGATGGGTAGAAAAACAT
ACCGCTCGTACCGATGGGT -> CCGCTCGTACCGATGGGTA
ACCGCTTGCACCAATTGAT -> CCGCTTGCACCAATTGATC
ACCGGAAGGAAGAAATTCC -> CCGGAAGGAAGAAATTCCT
ACCGGTCGTGATCAAAAAC -> CCGGTCGTGATCAAAAACA
ACCGTGCGCGAGACCGAAT -> CCGTGCGCGAGACCGAATT
ACCGTGTTTTTCGTCCCCA -> CCGTGTTTTTCGTCCCCAT
ACCGTTTGGATGCTTGCGT -> CCGTTTGGATGCTTGCGTC
ACCTAGATACGCTCCACTA -> CCTAGATACGCTCCACTAA
ACCTCAAGACTGTGGAGCA -> CCTCAAGACTGTGGAGCAC
ACCTCACGTGTGCGTTTGC -> CCTCACGTGTGCGTTTGCA
ACCTGTCATTGCCTACCGT -> CCTGTCATTGCCTACCGTG
ACCTTAAGCACCCTCAGCC -> CCTTAAGCACCCTCAGCCC
ACCTTGGTGTTTGCGACGG -> CCTTGGTGTTTGCGACGGA
ACGAAATGTGTATTACGTA -> CGAAATGTGTATTACGTAG
ACGAAGGCAAATTCGCCTC -> CGAAGGCAAATTCGCCTCG
ACGAATCTACGTGAATAGC -> CGAATCTACGTGAATAGCT
ACGAATGACGACGGCTCGG -> CGAATGACGACGGCTCGGC
ACGACGATCCACTCGAAGC -> CGACGATCCACTCGAAGCA
ACGACGGCTCGGCCGAGGT -> CGACGGCTCGGCCGAGGTG
ACGACTACCCTTCCGCGAA -> CGACTACCCTTCCGCGAAA
ACGACTCCAAATCAAAACT -> CGACTCCAAATCAAAACTC
ACGAGTACACTAAATGCCT -> CGAGTACACTAAATGCCTG
ACGATAACGCGAGCGCATG -> CGATAACGCGAGCGCATGT
ACGATATTCCGGTATAGTC -> CGATATTCCGGTATAGTCG
ACGATCCACTCGAAGCATG -> CGATCCACTCGAAGCATGT
ACGCACAATTATATCAGGC -> CGCACAATTATATCAGGCT
ACGCATAGAACATACCGTG -> CGCATAGAACATACCGTGT
ACGCCAGGAGGAGCCAGGC -> CGCCAGGAGGAGCCAGGCG
ACGCCGAAGTACTGTTGGT -> CGCCGAAGTACTGTTGGTC
ACGCCGGGACTCTCTGAGC -> CGCCGGGACTCTCTGAGCT
ACGCCTTTCATCCCTGGCA -> CGCCTTTCATCCCTGGCAG
ACGCGAACCGAGACTTACG -> CGCGAACCGAGACTTACGA
ACGCGAGCGCATGTAGAAG -> CGCGAGCGCATGTAGAAGT
ACGCGTAAGGCAGTATGGA -> CGCGTAAGGCAGTATGGAC
ACGCTCCACTAAAGCACTG -> CGCTCCACTAAAGCACTGT
ACGGAACTGGCGAGCCCAT -> CGGAACTGGCGAGCCCATC
ACGGACGTGCCTTGCAAGG -> CGGACGTGCCTTGCAAGGA
ACGGATGAGATATCGCTTC -> CGGATGAGATATCGCTTCA
ACGGATTGTACCAACACTC -> CGGATTGTACCAACACTCC
ACGGCGTAGGCCTTAGGCT -> CGGCGTAGGCCTTAGGCTT
ACGGCTCGGCCGAGGTGCA -> CGGCTCGGCCGAGGTGCAT
ACGGGAACCTTGGTGTTTG -> CGGGAACCTTGGTGTTTGC
ACGGTCCGGGAATACCAGT -> CGGTCCGGGAATACCAGTT
ACGTAGGTGAACCGTTTGG -> CGTAGGTGAACCGTTTGGA
ACGTCCAGTTTGGTGCGAT -> CGTCCAGTTTGGTGCGATA
ACGTCGGGTCCGGACTATC -> CGTCGGGTCCGGACTATCG
ACGTGAATAGCTGTTGGCT -> CGTGAATAGCTGTTGGCTT
ACGTGCCTTGCAAGGATGC -> CGTGCCTTGCAAGGATGCA
ACGTGTGCGTTTGCAGGCT -> CGTGTGCGTTTGCAGGCTT
ACGTTGCCTACGACGATCC -> CGTTGCCTACGACGATCCA
ACTAAACGCCGGGACTCTC -> CTAAACGCCGGGACTCTCT
ACTAAAGCACTGTAATCTG -> CTAAAGCACTGTAATCTGG
ACTAAAGGGTTGAAGACAG -> CTAAAGGGTTGAAGACAGT
ACTAAATGCCTGCCGCGAA -> CTAAATGCCTGCCGCGAAA
ACTAAATGCCTGCCGCGAC -> CTAAATGCCTGCCGCGACC
ACTAAATGCCTGCCGCGAT -> CTAAATGCCTGCCGCGATA
ACTACCCTTCCGCGAAACA -> CTACCCTTCCGCGAAACAG
ACTAGATCTGGCCGGGCGC -> CTAGATCTGGCCGGGCGCC
ACTATCGTTAAAACTTTTT -> CTATCGTTAAAACTTTTTC
ACTATTGTATGATCGGGCG -> CTATTGTATGATCGGGCGG
ACTCAGAAACGGAACTGGC -> CTCAGAAACGGAACTGGCG
ACTCCAAATCAAAACTCTT -> CTCCAAATCAAAACTCTTG
ACTCCTTGAGTCCATGATA -> CTCCTTGAGTCCATGATAG
ACTCGAAGCATGTTTGGCC -> CTCGAAGCATGTTTGGCCC
ACTCGCCGTGAGCAATTTA -> CTCGCCGTGAGCAATTTAT
ACTCTCTGAGCTCTGATCC -> CTCTCTGAGCTCTGATCCG
ACTCTTAGCTAACGTTGCC -> CTCTTAGCTAACGTTGCCT
ACTCTTGAAATATTCCGTT -> CTCTTGAAATATTCCGTTA
ACTCTTGCTTGCCCAGGGG -> CTCTTGCTTGCCCAGGGGC
ACTGACCTGTCATTGCCTA -> CTGACCTGTCATTGCCTAC
ACTGCCGTGTTATGCAGTA -> CTGCCGTGTTATGCAGTAG
ACTGCTTAGGTTGCCAGGA -> CTGCTTAGGTTGCCAGGAG
ACTGGCATCCACTTAGTGC -> CTGGCATCCACTTAGTGCA
ACTGGCGAGCCCATCACCG -> CTGGCGAGCCCATCACCGG
ACTGGGCTTCTAAGTTACC -> CTGGGCTTCTAAGTTACCA
ACTGTAATCTGGCCGGGCG -> CTGTAATCTGGCCGGGCGC
ACTGTAGACATGAGATGGT -> CTGTAGACATGAGATGGTA
ACTGTGGAGCACGGACGTG -> CTGTGGAGCACGGACGTGC
ACTGTTGGTCGCGATGTTT -> CTGTTGGTCGCGATGTTTG
ACTTACGATATTCCGGTAT -> CTTACGATATTCCGGTATA
ACTTAGTGCAGCTTGCATT -> CTTAGTGCAGCTTGCATTC
ACTTGAACACTAAATGCCT -> CTTGAACACTAAATGCCTG
ACTTGGGTCCTTAATCGCA -> CTTGGGTCCTTAATCGCAC
ACTTTCGGGTAACGAAGGC -> CTTTCGGGTAACGAAGGCA
ACTTTTCCAAATGGATGTA -> CTTTTCCAAATGGATGTAC
ACTTTTGTCTGCACTAGAT -> CTTTTGTCTGCACTAGATC
ACTTTTTCCCAGGGTTCGC -> CTTTTTCCCAGGGTTCGCC
ACTTTTTTCGCCTATGCCT -> CTTTTTTCGCCTATGCCTG
AGAAAAACATTGTATGCTC -> GAAAAACATTGTATGCTCA
AGAAACGGAACTGGCGAGC -> GAAACGGAACTGGCGAGCC
AGAAATTCCTCATGCAGTT -> GAAATTCCTCATGCAGTTT
AGAACATACCGTGTTTTTC -> GAACATACCGTGTTTTTCG
AGAACCGGTCGTGATCAAA -> GAACCGGTCGTGATCAAAA
AGAACGGTCCGGGAATACC -> GAACGGTCCGGGAATACCA
AGAAGAGTTCTTATTACTA -> GAAGAGTTCTTATTACTAA
AGAAGGCGGTACAACAGCG -> GAAGGCGGTACAACAGCGC
AGAAGTACGGGAACCTTGG -> GAAGTACGGGAACCTTGGT
AGACAGTAAGTCAGTTCAG -> GACAGTAAGTCAGTTCAGT
AGACATGAGATGGTAACTC -> GACATGAGATGGTAACTCT
AGACATTGTGGCTTGTTCA -> GACATTGTGGCTTGTTCAG
AGACCGAATTAATCCCTTT -> GACCGAATTAATCCCTTTA
AGACTGTGGAGCACGGACG -> GACTGTGGAGCACGGACGT
AGACTTACGATATTCCGGT -> GACTTACGATATTCCGGTA
AGACTTGAACACTAAATGC -> GACTTGAACACTAAATGCC
AGACTTGGGTCCTTAATCG -> GACTTGGGTCCTTAATCGC
AGAGGAGCCTCTTTACCTA -> GAGGAGCCTCTTTACCTAG
AGAGTTATACAGTTGAAAC -> GAGTTATACAGTTGAAACT
AGAGTTCTTATTACTAAAC -> GAGTTCTTATTACTAAACG
AGATACGCTCCACTAAAGC -> GATACGCTCCACTAAAGCA
AGATATCGCTTCAAACAGG -> GATATCGCTTCAAACAGGT
AGATCTGGCCGGGCGCCAG -> GATCTGGCCGGGCGCCAGT
AGATGGTAACTCTTAGCTA -> GATGGTAACTCTTAGCTAA
AGATTGGTAGTGCCTTACA -> GATTGGTAGTGCCTTACAA
AGCAACACGAATCTACGTG -> GCAACACGAATCTACGTGA
AGCAACTCTTGAAATATTC -> GCAACTCTTGAAATATTCC
AGCAATTTATGTCCCGATC -> GCAATTTATGTCCCGATCG
AGCACCCTCAGCCCAACGA -> GCACCCTCAGCCCAACGAT
AGCACGGACGTGCCTTGCA -> GCACGGACGTGCCTTGCAA
AGCACTGTAATCTGGCCGG -> GCACTGTAATCTGGCCGGG
AGCAGCCACGAAATGTGTA -> GCAGCCACGAAATGTGTAT
AGCAGTCTCAAACCCCGGG -> GCAGTCTCAAACCCCGGGA
AGCATGTTTGGCCCTGGGG -> GCATGTTTGGCCCTGGGGC
AGCCACGAAATGTGTATTA -> GCCACGAAATGTGTATTAC
AGCCAGGCGAACCATTATG -> GCCAGGCGAACCATTATGG
AGCCCAACGATAACGCGAG -> GCCCAACGATAACGCGAGC
AGCCCATCACCGGAAGGAA -> GCCCATCACCGGAAGGAAG
AGCCCGCTACGAATGACGA -> GCCCGCTACGAATGACGAC
AGCCTCACGTCCAGTTTGG -> GCCTCACGTCCAGTTTGGT
AGCCTCTTTACCTAGATAC -> GCCTCTTTACCTAGATACG
AGCGATCCCACAAGGTTCG -> GCGATCCCACAAGGTTCGG
AGCGCATGTAGAAGTACGG -> GCGCATGTAGAAGTACGGG
AGCGCTAATAGGACAGACA -> GCGCTAATAGGACAGACAT
AGCTAACGTTGCCTACGAC -> GCTAACGTTGCCTACGACG
AGCTCTGATCCGTTCGCTT -> GCTCTGATCCGTTCGCTTG
AGCTGAGTCTTCTCATTCC -> GCTGAGTCTTCTCATTCCT
AGCTGTTGGCTTGGTTCGC -> GCTGTTGGCTTGGTTCGCG
AGCTTGCATTCCTGACCGC -> GCTTGCATTCCTGACCGCT
AGGAAGAAATTCCTCATGC -> GGAAGAAATTCCTCATGCA
AGGACAGACATTGTGGCTT -> GGACAGACATTGTGGCTTG
AGGAGAACCGGTCGTGATC -> GGAGAACCGGTCGTGATCA
AGGAGCCAGGCGAACCATT -> GGAGCCAGGCGAACCATTA
AGGAGCCTCTTTACCTAGA -> GGAGCCTCTTTACCTAGAT
AGGAGGAGCCAGGCGAACC -> GGAGGAGCCAGGCGAACCA
AGGATGCAGCAACACGAAT -> GGATGCAGCAACACGAATC
AGGATTCTTCCGGGCGTCC -> GGATTCTTCCGGGCGTCCG
AGGCAAATTCGCCTCGTGG -> GGCAAATTCGCCTCGTGGT
AGGCAGGGGTCGTAGCAGC -> GGCAGGGGTCGTAGCAGCC
AGGCAGTATGGACGCATAG -> GGCAGTATGGACGCATAGA
AGGCCTTAGGCTTTGCGTT -> GGCCTTAGGCTTTGCGTTT
AGGCGAACCATTATGGCGT -> GGCGAACCATTATGGCGTG
AGGCGGTACAACAGCGCTA -> GGCGGTACAACAGCGCTAA
AGGCTACTCAGAAACGGAA -> GGCTACTCAGAAACGGAAC
AGGCTTGCCCCATTATCCA -> GGCTTGCCCCATTATCCAC
AGGCTTTCAAGACTTGGGT -> GGCTTTCAAGACTTGGGTC
AGGCTTTGCGTTTTGCCGG -> GGCTTTGCGTTTTGCCGGG
AGGGATTGGACGCCTTTCA -> GGGATTGGACGCCTTTCAT
AGGGCCCCGTCAAATTCCT -> GGGCCCCGTCAAATTCCTC
AGGGGCCTGGACGCCAGGA -> GGGGCCTGGACGCCAGGAG
AGGGGTCGTAGCAGCCACG -> GGGGTCGTAGCAGCCACGA
AGGGTTCGCCAGGTGAACT -> GGGTTCGCCAGGTGAACTA
AGGGTTGAAGACAGTAAGT -> GGGTTGAAGACAGTAAGTC
AGGTCCTTGCCCCATTTCA -> GGTCCTTGCCCCATTTCAT
AGGTGAACCGTTTGGATGC -> GGTGAACCGTTTGGATGCT
AGGTGAACTATTGTATGAT -> GGTGAACTATTGTATGATC
AGGTGAATTCTCGGGCTAA -> GGTGAATTCTCGGGCTAAC
AGGTGCATTTTTTGTCGTT -> GGTGCATTTTTTGTCGTTG
AGGTGCCCGTTCTGTAGAA -> GGTGCCCGTTCTGTAGAAG
AGGTGGGTTTCGACCATGG -> GGTGGGTTTCGACCATGGC
AGGTTCCCGTATCTGGCCG -> GGTTCCCGTATCTGGCCGG
AGGTTCCGATTAACGCCGA -> GGTTCCGATTAACGCCGAA
AGGTTCGGCACTGGCATCC -> GGTTCGGCACTGGCATCCA
AGGTTGCCAGGAGAACCGG -> GGTTGCCAGGAGAACCGGT
AGGTTTTTACTGGGCTTCT -> GGTTTTTACTGGGCTTCTA
AGTAAACGACTACCCTTCC -> GTAAACGACTACCCTTCCG
AGTAAGTCAGTTCAGTGCA -> GTAAGTCAGTTCAGTGCAA
AGTACACTAAATGCCTGCC -> GTACACTAAATGCCTGCCG
AGTACGGGAACCTTGGTGT -> GTACGGGAACCTTGGTGTT
AGTACTGTTGGTCGCGATG -> GTACTGTTGGTCGCGATGT
AGTACTTTTGTCTGCACTA -> GTACTTTTGTCTGCACTAG
AGTAGATTGGTAGTGCCTT -> GTAGATTGGTAGTGCCTTA
AGTATGGACGCATAGAACA -> GTATGGACGCATAGAACAT
AGTCAGTTCAGTGCAAACA -> GTCAGTTCAGTGCAAACAC
AGTCCATGATAGGATTCTT -> GTCCATGATAGGATTCTTC
AGTCGTACGCACAATTATA -> GTCGTACGCACAATTATAT
AGTCGTTTACAAATCACTA -> GTCGTTTACAAATCACTAA
AGTCTCAAACCCCGGGAAA -> GTCTCAAACCCCGGGAAAG
AGTCTTCTCATTCCTATAT -> GTCTTCTCATTCCTATATC
AGTGCAAACACGACTCCAA -> GTGCAAACACGACTCCAAA
AGTGCAGCTTGCATTCCTG -> GTGCAGCTTGCATTCCTGA
AGTGCCTTACAATACCTCA -> GTGCCTTACAATACCTCAC
AGTGTAGACTTGAACACTA -> GTGTAGACTTGAACACTAA
AGTTACCAAATATTCCACC -> GTTACCAAATATTCCACCC
AGTTAGGGATTGGACGCCT -> GTTAGGGATTGGACGCCTT
AGTTATACAGTTGAAACTA -> GTTATACAGTTGAAACTAA
AGTTATCACGAGTACACTA -> GTTATCACGAGTACACTAA
AGTTCAGTGCAAACACGAC -> GTTCAGTGCAAACACGACT
AGTTCTCGAACCTTAAGCA -> GTTCTCGAACCTTAAGCAC
AGTTCTTATTACTAAACGC -> GTTCTTATTACTAAACGCC
AGTTGAAACTAAAGGGTTG -> GTTGAAACTAAAGGGTTGA
AGTTTCTAACGGCGTAGGC -> GTTTCTAACGGCGTAGGCC
AGTTTGCAGGTGGGTTTCG -> GTTTGCAGGTGGGTTTCGA
AGTTTGGTGCGATAAGCAA -> GTTTGGTGCGATAAGCAAC
AGTTTTCAATGGATGGTTT -> GTTTTCAATGGATGGTTTA
ATAACGCGAGCGCATGTAG -> TAACGCGAGCGCATGTAGA
ATAACTCGCCGTGAGCAAT -> TAACTCGCCGTGAGCAATT
ATAAGCAACTCTTGAAATA -> TAAGCAACTCTTGAAATAT
ATACAGTTGAAACTAAAGG -> TACAGTTGAAACTAAAGGG
ATACCACAACTTTTTTCGC -> TACCACAACTTTTTTCGCC
ATACCAGTTTTCAATGGAT -> TACCAGTTTTCAATGGATG
ATACCGTGTTTTTCGTCCC -> TACCGTGTTTTTCGTCCCC
ATACCTCACGTGTGCGTTT -> TACCTCACGTGTGCGTTTG
ATACGCTCCACTAAAGCAC -> TACGCTCCACTAAAGCACT
ATAGAACATACCGTGTTTT -> TAGAACATACCGTGTTTTT
ATAGCCTCACGTCCAGTTT -> TAGCCTCACGTCCAGTTTG
ATAGCTGTTGGCTTGGTTC -> TAGCTGTTGGCTTGGTTCG
ATAGGACAGACATTGTGGC -> TAGGACAGACATTGTGGCT
ATAGGATTCTTCCGGGCGT -> TAGGATTCTTCCGGGCGTC
ATAGGTCCTTGCCCCATTT -> TAGGTCCTTGCCCCATTTC
ATAGTCGTACGCACAATTA -> TAGTCGTACGCACAATTAT
ATATCAGGCTTTCAAGACT -> TATCAGGCTTTCAAGACTT
ATATCGCTTCAAACAGGTG -> TATCGCTTCAAACAGGTGC
ATATCTTGGGGGGATGACT -> TATCTTGGGGGGATGACTT
ATATTCCACCCTACAGTTT -> TATTCCACCCTACAGTTTC
ATATTCCGGTATAGTCGTA -> TATTCCGGTATAGTCGTAC
ATATTCCGTTATCATCTGG -> TATTCCGTTATCATCTGGC
ATCAAAAACAGGCTACTCA -> TCAAAAACAGGCTACTCAG
ATCAAAACTCTTGCTTGCC -> TCAAAACTCTTGCTTGCCC
ATCACCGGAAGGAAGAAAT -> TCACCGGAAGGAAGAAATT
ATCACGAGTACACTAAATG -> TCACGAGTACACTAAATGC
ATCACTAAATGCCTGCCGC -> TCACTAAATGCCTGCCGCG
ATCAGGCTTTCAAGACTTG -> TCAGGCTTTCAAGACTTGG
ATCATCTGGCCGGGCGCCA -> TCATCTGGCCGGGCGCCAG
ATCCACTCGAAGCATGTTT -> TCCACTCGAAGCATGTTTG
ATCCACTGCTTAGGTTGCC -> TCCACTGCTTAGGTTGCCA
ATCCACTTAGTGCAGCTTG -> TCCACTTAGTGCAGCTTGC
ATCCCACAAGGTTCGGCAC -> TCCCACAAGGTTCGGCACT
ATCCCAGTTAGGGATTGGA -> TCCCAGTTAGGGATTGGAC
ATCCCTGGCAGCGATCCCA -> TCCCTGGCAGCGATCCCAC
ATCCCTTTAGCTGAGTCTT -> TCCCTTTAGCTGAGTCTTC
ATCCGATCTCTTCTTTGTT -> TCCGATCTCTTCTTTGTTG
ATCCGTTCGCTTGATGACT -> TCCGTTCGCTTGATGACTG
ATCGCACGCGTAAGGCAGT -> TCGCACGCGTAAGGCAGTA
ATCGCTTCAAACAGGTGCC -> TCGCTTCAAACAGGTGCCC
ATCGGACTGCCGTGTTATG -> TCGGACTGCCGTGTTATGC
ATCGGCTGTCCCCACTTTT -> TCGGCTGTCCCCACTTTTC
ATCGGGCGGGGGCGGGTTA -> TCGGGCGGGGGCGGGTTAA
ATCGTTAAAACTTTTTCCC -> TCGTTAAAACTTTTTCCCA
ATCTACGTGAATAGCTGTT -> TCTACGTGAATAGCTGTTG
ATCTCTTCTTTGTTGGAAC -> TCTCTTCTTTGTTGGAACA
ATCTGGCCGGGCGCCAGTA -> TCTGGCCGGGCGCCAGTAC
ATCTGGCCGGGCGCCAGTC -> TCTGGCCGGGCGCCAGTCG
ATCTGGCCGGGCGCCAGTG -> TCTGGCCGGGCGCCAGTGT
ATCTGGCCGGGCGCCAGTT -> TCTGGCCGGGCGCCAGTTA
ATCTTGGGGGGATGACTTT -> TCTTGGGGGGATGACTTTC
ATGACGACGGCTCGGCCGA -> TGACGACGGCTCGGCCGAG
ATGACTGACCTGTCATTGC -> TGACTGACCTGTCATTGCC
ATGACTTTCGGGTAACGAA -> TGACTTTCGGGTAACGAAG
ATGAGATATCGCTTCAAAC -> TGAGATATCGCTTCAAACA
ATGAGATGGTAACTCTTAG -> TGAGATGGTAACTCTTAGC
ATGATAGGATTCTTCCGGG -> TGATAGGATTCTTCCGGGC
ATGATCGGGCGGGGGCGGG -> TGATCGGGCGGGGGCGGGT
ATGCAGCAACACGAATCTA -> TGCAGCAACACGAATCTAC
ATGCAGTAGATTGGTAGTG -> TGCAGTAGATTGGTAGTGC
ATGCAGTTTGCAGGTGGGT -> TGCAGTTTGCAGGTGGGTT
ATGCCTGCCGCGAAATGCC -> TGCCTGCCGCGAAATGCCT
ATGCCTGCCGCGAATTTTC -> TGCCTGCCGCGAATTTTCA
ATGCCTGCCGCGACCAATT -> TGCCTGCCGCGACCAATTG
ATGCCTGCCGCGATAGGTC -> TGCCTGCCGCGATAGGTCC
ATGCCTGTTCCGCCGGATT -> TGCCTGTTCCGCCGGATTC
ATGCTCATCCGATCTCTTC -> TGCTCATCCGATCTCTTCT
ATGCTTGCGTCATTCTCGT -> TGCTTGCGTCATTCTCGTT
ATGGACGCATAGAACATAC -> TGGACGCATAGAACATACC
ATGGATGGTTTACGCGAAC -> TGGATGGTTTACGCGAACC
ATGGATGTACCTCAAGACT -> TGGATGTACCTCAAGACTG
ATGGCGCTTTGCCAATACC -> TGGCGCTTTGCCAATACCA
ATGGCGTGCTGATGTTTTT -> TGGCGTGCTGATGTTTTTC
ATGGGTAGAAAAACATTGT -> TGGGTAGAAAAACATTGTA
ATGGTAACTCTTAGCTAAC -> TGGTAACTCTTAGCTAACG
ATGGTTTACGCGAACCGAG -> TGGTTTACGCGAACCGAGA
ATGTACCTCAAGACTGTGG -> TGTACCTCAAGACTGTGGA
ATGTAGAAGTACGGGAACC -> TGTAGAAGTACGGGAACCT
ATGTCGTAGGCAGGGGTCG -> TGTCGTAGGCAGGGGTCGT
ATGTGTATTACGTAGGTGA -> TGTGTATTACGTAGGTGAA
ATGTTTGGCCCTGGGGCTG -> TGTTTGGCCCTGGGGCTGC
ATGTTTGTCGTCGACCGCT -> TGTTTGTCGTCGACCGCTT
ATGTTTTTCGCCTCTATGT -> TGTTTTTCGCCTCTATGTC
ATTAACGCCGAAGTACTGT -> TTAACGCCGAAGTACTGTT
ATTAATCCCTTTAGCTGAG -> TTAATCCCTTTAGCTGAGT
ATTACGTAGGTGAACCGTT -> TTACGTAGGTGAACCGTTT
ATTACTAAACGCCGGGACT -> TTACTAAACGCCGGGACTC
ATTATATCAGGCTTTCAAG -> TTATATCAGGCTTTCAAGA
ATTATCCACTGCTTAGGTT -> TTATCCACTGCTTAGGTTG
ATTATGGCGTGCTGATGTT -> TTATGGCGTGCTGATGTTT
ATTCCACCCTACAGTTTCT -> TTCCACCCTACAGTTTCTA
ATTCCGGTATAGTCGTACG -> TTCCGGTATAGTCGTACGC
ATTCCGTTATCATCTGGCC -> TTCCGTTATCATCTGGCCG
ATTCCTATATCTTGGGGGG -> TTCCTATATCTTGGGGGGA
ATTCCTCATGCAGTTTGCA -> TTCCTCATGCAGTTTGCAG
ATTCCTCTTTCCCCTAAGC -> TTCCTCTTTCCCCTAAGCA
ATTCCTGACCGCTCGTACC -> TTCCTGACCGCTCGTACCG
ATTCGCCTCGTGGTCTGGC -> TTCGCCTCGTGGTCTGGCG
ATTCTCGCGAGGTTTTTAC -> TTCTCGCGAGGTTTTTACT
ATTCTCGGGCTAACCAAAC -> TTCTCGGGCTAACCAAACT
ATTCTCGTTGTAAATTTCC -> TTCTCGTTGTAAATTTCCC
ATTCTTCCGGGCGTCCGAG -> TTCTTCCGGGCGTCCGAGA
ATTGAAACGTCGGGTCCGG -> TTGAAACGTCGGGTCCGGA
ATTGATCGGACTGCCGTGT -> TTGATCGGACTGCCGTGTT
ATTGCCTACCGTGCGCGAG -> TTGCCTACCGTGCGCGAGA
ATTGCTGCTAAATCGGCTG -> TTGCTGCTAAATCGGCTGT
ATTGGACGCCTTTCATCCC -> TTGGACGCCTTTCATCCCT
ATTGGTAGTGCCTTACAAT -> TTGGTAGTGCCTTACAATA
ATTGTAAGCCCGCTACGAA -> TTGTAAGCCCGCTACGAAT
ATTGTACCAACACTCCTTG -> TTGTACCAACACTCCTTGA
ATTGTATGATCGGGCGGGG -> TTGTATGATCGGGCGGGGG
ATTGTATGCTCATCCGATC -> TTGTATGCTCATCCGATCT
ATTGTGGCTTGTTCAGGTT -> TTGTGGCTTGTTCAGGTTC
ATTTCATTGCTGCTAAATC -> TTTCATTGCTGCTAAATCG
ATTTCCCGATCCCAGTTAG -> TTTCCCGATCCCAGTTAGG
ATTTTCAAGGTTCCCGTAT -> TTTTCAAGGTTCCCGTATC
ATTTTTTGTCGTTGGGAGT -> TTTTTTGTCGTTGGGAGTA
CAAAAACAGGCTACTCAGA -> AAAAACAGGCTACTCAGAA
CAAAACTCTTGCTTGCCCA -> AAAACTCTTGCTTGCCCAG
CAAACACGACTCCAAATCA -> AAACACGACTCCAAATCAA
CAAACAGGTGCCCGTTCTG -> AAACAGGTGCCCGTTCTGT
CAAACCCCGGGAAAGGTGA -> AAACCCCGGGAAAGGTGAA
CAAACTGTAGACATGAGAT -> AAACTGTAGACATGAGATG
CAAATATTCCACCCTACAG -> AAATATTCCACCCTACAGT
CAAATCAAAACTCTTGCTT -> AAATCAAAACTCTTGCTTG
CAAATCACTAAATGCCTGC -> AAATCACTAAATGCCTGCC
CAAATGGATGTACCTCAAG -> AAATGGATGTACCTCAAGA
CAAATTCCTCTTTCCCCTA -> AAATTCCTCTTTCCCCTAA
CAAATTCGCCTCGTGGTCT -> AAATTCGCCTCGTGGTCTG
CAACACGAATCTACGTGAA -> AACACGAATCTACGTGAAT
CAACACTCCTTGAGTCCAT -> AACACTCCTTGAGTCCATG
CAACAGCGCTAATAGGACA -> AACAGCGCTAATAGGACAG
CAACGATAACGCGAGCGCA -> AACGATAACGCGAGCGCAT
CAACTCTTGAAATATTCCG -> AACTCTTGAAATATTCCGT
CAACTTTTTTCGCCTATGC -> AACTTTTTTCGCCTATGCC
CAAGACTGTGGAGCACGGA -> AAGACTGTGGAGCACGGAC
CAAGACTTGGGTCCTTAAT -> AAGACTTGGGTCCTTAATC
CAAGGATGCAGCAACACGA -> AAGGATGCAGCAACACGAA
CAAGGTTCCCGTATCTGGC -> AAGGTTCCCGTATCTGGCC
CAAGGTTCGGCACTGGCAT -> AAGGTTCGGCACTGGCATC
CAATACCACAACTTTTTTC -> AATACCACAACTTTTTTCG
CAATACCTCACGTGTGCGT -> AATACCTCACGTGTGCGTT
CAATGGATGGTTTACGCGA -> AATGGATGGTTTACGCGAA
CAATTATATCAGGCTTTCA -> AATTATATCAGGCTTTCAA
CAATTGATCGGACTGCCGT -> AATTGATCGGACTGCCGTG
CAATTGTAAGCCCGCTACG -> AATTGTAAGCCCGCTACGA
CACAACTTTTTTCGCCTAT -> ACAACTTTTTTCGCCTATG
CACAAGGTTCGGCACTGGC -> ACAAGGTTCGGCACTGGCA
CACAATTATATCAGGCTTT -> ACAATTATATCAGGCTTTC
CACACGGATGAGATATCGC -> ACACGGATGAGATATCGCT
CACCAATTGATCGGACTGC -> ACCAATTGATCGGACTGCC
CACCCTACAGTTTCTAACG -> ACCCTACAGTTTCTAACGG
CACCCTCAGCCCAACGATA -> ACCCTCAGCCCAACGATAA
CACCGGAAGGAAGAAATTC -> ACCGGAAGGAAGAAATTCC
CACGAAATGTGTATTACGT -> ACGAAATGTGTATTACGTA
CACGAATCTACGTGAATAG -> ACGAATCTACGTGAATAGC
CACGACTCCAAATCAAAAC -> ACGACTCCAAATCAAAACT
CACGAGTACACTAAATGCC -> ACGAGTACACTAAATGCCT
CACGCGTAAGGCAGTATGG -> ACGCGTAAGGCAGTATGGA
CACGGACGTGCCTTGCAAG -> ACGGACGTGCCTTGCAAGG
CACGGATGAGATATCGCTT -> ACGGATGAGATATCGCTTC
CACGTCCAGTTTGGTGCGA -> ACGTCCAGTTTGGTGCGAT
CACGTGTGCGTTTGCAGGC -> ACGTGTGCGTTTGCAGGCT
CACTAAAGCACTGTAATCT -> ACTAAAGCACTGTAATCTG
CACTAAATGCCTGCCGCGA -> ACTAAATGCCTGCCGCGAT,ACTAAATGCCTGCCGCGAC,ACTAAATGCCTGCCGCGAA
CACTAGATCTGGCCGGGCG -> ACTAGATCTGGCCGGGCGC
CACTCCTTGAGTCCATGAT -> ACTCCTTGAGTCCATGATA
CACTCGAAGCATGTTTGGC -> ACTCGAAGCATGTTTGGCC
CACTGCTTAGGTTGCCAGG -> ACTGCTTAGGTTGCCAGGA
CACTGGCATCCACTTAGTG -> ACTGGCATCCACTTAGTGC
CACTGTAATCTGGCCGGGC -> ACTGTAATCTGGCCGGGCG
CACTTAGTGCAGCTTGCAT -> ACTTAGTGCAGCTTGCATT
CACTTTTCCAAATGGATGT -> ACTTTTCCAAATGGATGTA
CAGAAACGGAACTGGCGAG -> AGAAACGGAACTGGCGAGC
CAGAAGAGTTCTTATTACT -> AGAAGAGTTCTTATTACTA
CAGACATTGTGGCTTGTTC -> AGACATTGTGGCTTGTTCA
CAGCAACACGAATCTACGT -> AGCAACACGAATCTACGTG
CAGCCACGAAATGTGTATT -> AGCCACGAAATGTGTATTA
CAGCCCAACGATAACGCGA -> AGCCCAACGATAACGCGAG
CAGCGATCCCACAAGGTTC -> AGCGATCCCACAAGGTTCG
CAGCGCTAATAGGACAGAC -> AGCGCTAATAGGACAGACA
CAGCTTGCATTCCTGACCG -> AGCTTGCATTCCTGACCGC
CAGGAGAACCGGTCGTGAT -> AGGAGAACCGGTCGTGATC
CAGGAGGAGCCAGGCGAAC -> AGGAGGAGCCAGGCGAACC
CAGGCGAACCATTATGGCG -> AGGCGAACCATTATGGCGT
CAGGCTACTCAGAAACGGA -> AGGCTACTCAGAAACGGAA
CAGGCTTGCCCCATTATCC -> AGGCTTGCCCCATTATCCA
CAGGCTTTCAAGACTTGGG -> AGGCTTTCAAGACTTGGGT
CAGGGCCCCGTCAAATTCC -> AGGGCCCCGTCAAATTCCT
CAGGGGCCTGGACGCCAGG -> AGGGGCCTGGACGCCAGGA
CAGGGGTCGTAGCAGCCAC -> AGGGGTCGTAGCAGCCACG
CAGGGTTCGCCAGGTGAAC -> AGGGTTCGCCAGGTGAACT
CAGGTGAACTATTGTATGA -> AGGTGAACTATTGTATGAT
CAGGTGCCCGTTCTGTAGA -> AGGTGCCCGTTCTGTAGAA
CAGGTGGGTTTCGACCATG -> AGGTGGGTTTCGACCATGG
CAGGTTCCGATTAACGCCG -> AGGTTCCGATTAACGCCGA
CAGTAAGTCAGTTCAGTGC -> AGTAAGTCAGTTCAGTGCA
CAGTACTTTTGTCTGCACT -> AGTACTTTTGTCTGCACTA
CAGTAGATTGGTAGTGCCT -> AGTAGATTGGTAGTGCCTT
CAGTATGGACGCATAGAAC -> AGTATGGACGCATAGAACA
CAGTCGTTTACAAATCACT -> AGTCGTTTACAAATCACTA
CAGTCTCAAACCCCGGGAA -> AGTCTCAAACCCCGGGAAA
CAGTGCAAACACGACTCCA -> AGTGCAAACACGACTCCAA
CAGTGTAGACTTGAACACT -> AGTGTAGACTTGAACACTA
CAGTTAGGGATTGGACGCC -> AGTTAGGGATTGGACGCCT
CAGTTATCACGAGTACACT -> AGTTATCACGAGTACACTA
CAGTTCAGTGCAAACACGA -> AGTTCAGTGCAAACACGAC
CAGTTGAAACTAAAGGGTT -> AGTTGAAACTAAAGGGTTG
CAGTTTCTAACGGCGTAGG -> AGTTTCTAACGGCGTAGGC
CAGTTTGCAGGTGGGTTTC -> AGTTTGCAGGTGGGTTTCG
CAGTTTGGTGCGATAAGCA -> AGTTTGGTGCGATAAGCAA
CAGTTTTCAATGGATGGTT -> AGTTTTCAATGGATGGTTT
CATACCGTGTTTTTCGTCC -> ATACCGTGTTTTTCGTCCC
CATAGAACATACCGTGTTT -> ATAGAACATACCGTGTTTT
CATAGCCTCACGTCCAGTT -> ATAGCCTCACGTCCAGTTT
CATCACCGGAAGGAAGAAA -> ATCACCGGAAGGAAGAAAT
CATCCACTTAGTGCAGCTT -> ATCCACTTAGTGCAGCTTG
CATCCCTGGCAGCGATCCC -> ATCCCTGGCAGCGATCCCA
CATCCGATCTCTTCTTTGT -> ATCCGATCTCTTCTTTGTT
CATCTGGCCGGGCGCCAGT -> ATCTGGCCGGGCGCCAGTC
CATGAGATGGTAACTCTTA -> ATGAGATGGTAACTCTTAG
CATGATAGGATTCTTCCGG -> ATGATAGGATTCTTCCGGG
CATGCAGTTTGCAGGTGGG -> ATGCAGTTTGCAGGTGGGT
CATGGCGCTTTGCCAATAC -> ATGGCGCTTTGCCAATACC
CATGTAGAAGTACGGGAAC -> ATGTAGAAGTACGGGAACC
CATGTTTGGCCCTGGGGCT -> ATGTTTGGCCCTGGGGCTG
CATTATCCACTGCTTAGGT -> ATTATCCACTGCTTAGGTT
CATTATGGCGTGCTGATGT -> ATTATGGCGTGCTGATGTT
CATTCCTATATCTTGGGGG -> ATTCCTATATCTTGGGGGG
CATTCCTGACCGCTCGTAC -> ATTCCTGACCGCTCGTACC
CATTCTCGTTGTAAATTTC -> ATTCTCGTTGTAAATTTCC
CATTGAAACGTCGGGTCCG -> ATTGAAACGTCGGGTCCGG
CATTGCCTACCGTGCGCGA -> ATTGCCTACCGTGCGCGAG
CATTGCTGCTAAATCGGCT -> ATTGCTGCTAAATCGGCTG
CATTGTATGCTCATCCGAT -> ATTGTATGCTCATCCGATC
CATTGTGGCTTGTTCAGGT -> ATTGTGGCTTGTTCAGGTT
CATTTCATTGCTGCTAAAT -> ATTTCATTGCTGCTAAATC
CATTTTTTGTCGTTGGGAG -> ATTTTTTGTCGTTGGGAGT
CCAAACTGTAGACATGAGA -> CAAACTGTAGACATGAGAT
CCAAATATTCCACCCTACA -> CAAATATTCCACCCTACAG
CCAAATCAAAACTCTTGCT -> CAAATCAAAACTCTTGCTT
CCAAATGGATGTACCTCAA -> CAAATGGATGTACCTCAAG
CCAACACTCCTTGAGTCCA -> CAACACTCCTTGAGTCCAT
CCAACGATAACGCGAGCGC -> CAACGATAACGCGAGCGCA
CCAATACCACAACTTTTTT -> CAATACCACAACTTTTTTC
CCAATTGATCGGACTGCCG -> CAATTGATCGGACTGCCGT
CCAATTGTAAGCCCGCTAC -> CAATTGTAAGCCCGCTACG
CCACAACTTTTTTCGCCTA -> CACAACTTTTTTCGCCTAT
CCACAAGGTTCGGCACTGG -> CACAAGGTTCGGCACTGGC
CCACCCTACAGTTTCTAAC -> CACCCTACAGTTTCTAACG
CCACGAAATGTGTATTACG -> CACGAAATGTGTATTACGT
CCACTAAAGCACTGTAATC -> CACTAAAGCACTGTAATCT
CCACTCGAAGCATGTTTGG -> CACTCGAAGCATGTTTGGC
CCACTGCTTAGGTTGCCAG -> CACTGCTTAGGTTGCCAGG
CCACTTAGTGCAGCTTGCA -> CACTTAGTGCAGCTTGCAT
CCACTTTTCCAAATGGATG -> CACTTTTCCAAATGGATGT
CCAGGAGAACCGGTCGTGA -> CAGGAGAACCGGTCGTGAT
CCAGGAGGAGCCAGGCGAA -> CAGGAGGAGCCAGGCGAAC
CCAGGCGAACCATTATGGC -> CAGGCGAACCATTATGGCG
CCAGGGGCCTGGACGCCAG -> CAGGGGCCTGGACGCCAGG
CCAGGGTTCGCCAGGTGAA -> CAGGGTTCGCCAGGTGAAC
CCAGGTGAACTATTGTATG -> CAGGTGAACTATTGTATGA
CCAGTACTTTTGTCTGCAC -> CAGTACTTTTGTCTGCACT
CCAGTCGTTTACAAATCAC -> CAGTCGTTTACAAATCACT
CCAGTGTAGACTTGAACAC -> CAGTGTAGACTTGAACACT
CCAGTTAGGGATTGGACGC -> CAGTTAGGGATTGGACGCC
CCAGTTATCACGAGTACAC -> CAGTTATCACGAGTACACT
CCAGTTTGGTGCGATAAGC -> CAGTTTGGTGCGATAAGCA
CCAGTTTTCAATGGATGGT -> CAGTTTTCAATGGATGGTT
CCATAGCCTCACGTCCAGT -> CATAGCCTCACGTCCAGTT
CCATCACCGGAAGGAAGAA -> CATCACCGGAAGGAAGAAA
CCATGATAGGATTCTTCCG -> CATGATAGGATTCTTCCGG
CCATGGCGCTTTGCCAATA -> CATGGCGCTTTGCCAATAC
CCATTATCCACTGCTTAGG -> CATTATCCACTGCTTAGGT
CCATTATGGCGTGCTGATG -> CATTATGGCGTGCTGATGT
CCATTTCATTGCTGCTAAA -> CATTTCATTGCTGCTAAAT
CCCAACGATAACGCGAGCG -> CCAACGATAACGCGAGCGC
CCCACAAGGTTCGGCACTG -> CCACAAGGTTCGGCACTGG
CCCACTTTTCCAAATGGAT -> CCACTTTTCCAAATGGATG
CCCAGGGGCCTGGACGCCA -> CCAGGGGCCTGGACGCCAG
CCCAGGGTTCGCCAGGTGA -> CCAGGGTTCGCCAGGTGAA
CCCAGTTAGGGATTGGACG -> CCAGTTAGGGATTGGACGC
CCCATAGCCTCACGTCCAG -> CCATAGCCTCACGTCCAGT
CCCATCACCGGAAGGAAGA -> CCATCACCGGAAGGAAGAA
CCCATTATCCACTGCTTAG -> CCATTATCCACTGCTTAGG
CCCATTTCATTGCTGCTAA -> CCATTTCATTGCTGCTAAA
CCCCACTTTTCCAAATGGA -> CCCACTTTTCCAAATGGAT
CCCCATAGCCTCACGTCCA -> CCCATAGCCTCACGTCCAG
CCCCATTATCCACTGCTTA -> CCCATTATCCACTGCTTAG
CCCCATTTCATTGCTGCTA -> CCCATTTCATTGCTGCTAA
CCCCGGGAAAGGTGAATTC -> CCCGGGAAAGGTGAATTCT
CCCCGTCAAATTCCTCTTT -> CCCGTCAAATTCCTCTTTC
CCCCTAAGCAGTCTCAAAC -> CCCTAAGCAGTCTCAAACC
CCCGATCCCAGTTAGGGAT -> CCGATCCCAGTTAGGGATT
CCCGCTACGAATGACGACG -> CCGCTACGAATGACGACGG
CCCGGGAAAGGTGAATTCT -> CCGGGAAAGGTGAATTCTC
CCCGTATCTGGCCGGGCGC -> CCGTATCTGGCCGGGCGCC
CCCGTCAAATTCCTCTTTC -> CCGTCAAATTCCTCTTTCC
CCCGTTCTGTAGAAGGCGG -> CCGTTCTGTAGAAGGCGGT
CCCTAAGCAGTCTCAAACC -> CCTAAGCAGTCTCAAACCC
CCCTACAGTTTCTAACGGC -> CCTACAGTTTCTAACGGCG
CCCTCAGCCCAACGATAAC -> CCTCAGCCCAACGATAACG
CCCTGGCAGCGATCCCACA -> CCTGGCAGCGATCCCACAA
CCCTGGGGCTGCACACGGA -> CCTGGGGCTGCACACGGAT
CCCTTCCGCGAAACAGAAG -> CCTTCCGCGAAACAGAAGA
CCCTTTAGCTGAGTCTTCT -> CCTTTAGCTGAGTCTTCTC
CCGAAGTACTGTTGGTCGC -> CGAAGTACTGTTGGTCGCG
CCGAATTAATCCCTTTAGC -> CGAATTAATCCCTTTAGCT
CCGAGACTTACGATATTCC -> CGAGACTTACGATATTCCG
CCGAGAGGAGCCTCTTTAC -> CGAGAGGAGCCTCTTTACC
CCGAGGTGCATTTTTTGTC -> CGAGGTGCATTTTTTGTCG
CCGATCCCAGTTAGGGATT -> CGATCCCAGTTAGGGATTG
CCGATCTCTTCTTTGTTGG -> CGATCTCTTCTTTGTTGGA
CCGATGGGTAGAAAAACAT -> CGATGGGTAGAAAAACATT
CCGATTAACGCCGAAGTAC -> CGATTAACGCCGAAGTACT
CCGCCGGATTCTCGCGAGG -> CGCCGGATTCTCGCGAGGT
CCGCGAAACAGAAGAGTTC -> CGCGAAACAGAAGAGTTCT
CCGCGAAATGCCTGCCGCG -> CGCGAAATGCCTGCCGCGA
CCGCGAATTTTCAAGGTTC -> CGCGAATTTTCAAGGTTCC
CCGCGACCAATTGTAAGCC -> CGCGACCAATTGTAAGCCC
CCGCGATAGGTCCTTGCCC -> CGCGATAGGTCCTTGCCCC
CCGCTACGAATGACGACGG -> CGCTACGAATGACGACGGC
CCGCTCGTACCGATGGGTA -> CGCTCGTACCGATGGGTAG
CCGCTTGCACCAATTGATC -> CGCTTGCACCAATTGATCG
CCGGAAGGAAGAAATTCCT -> CGGAAGGAAGAAATTCCTC
CCGGACTATCGTTAAAACT -> CGGACTATCGTTAAAACTT
CCGGATTCTCGCGAGGTTT -> CGGATTCTCGCGAGGTTTT
CCGGGAAAGGTGAATTCTC -> CGGGAAAGGTGAATTCTCG
CCGGGAATACCAGTTTTCA -> CGGGAATACCAGTTTTCAA
CCGGGACTCTCTGAGCTCT -> CGGGACTCTCTGAGCTCTG
CCGGGCGCCAGTACTTTTG -> CGGGCGCCAGTACTTTTGT
CCGGGCGCCAGTCGTTTAC -> CGGGCGCCAGTCGTTTACA
CCGGGCGCCAGTGTAGACT -> CGGGCGCCAGTGTAGACTT
CCGGGCGCCAGTTATCACG -> CGGGCGCCAGTTATCACGA
CCGGGCGTCCGAGAGGAGC -> CGGGCGTCCGAGAGGAGCC
CCGGGTTTTTTCGGGCATT -> CGGGTTTTTTCGGGCATTG
CCGGTATAGTCGTACGCAC -> CGGTATAGTCGTACGCACA
CCGGTCGTGATCAAAAACA -> CGGTCGTGATCAAAAACAG
CCGTATCTGGCCGGGCGCC -> CGTATCTGGCCGGGCGCCA
CCGTCAAATTCCTCTTTCC -> CGTCAAATTCCTCTTTCCC
CCGTGAGCAATTTATGTCC -> CGTGAGCAATTTATGTCCC
CCGTGCGCGAGACCGAATT -> CGTGCGCGAGACCGAATTA
CCGTGTTATGCAGTAGATT -> CGTGTTATGCAGTAGATTG
CCGTGTTTTTCGTCCCCAT -> CGTGTTTTTCGTCCCCATA
CCGTTATCATCTGGCCGGG -> CGTTATCATCTGGCCGGGC
CCGTTCGCTTGATGACTGA -> CGTTCGCTTGATGACTGAC
CCGTTCTGTAGAAGGCGGT -> CGTTCTGTAGAAGGCGGTA
CCGTTTGGATGCTTGCGTC -> CGTTTGGATGCTTGCGTCA
CCTAAGCAGTCTCAAACCC -> CTAAGCAGTCTCAAACCCC
CCTACAGTTTCTAACGGCG -> CTACAGTTTCTAACGGCGT
CCTACCGTGCGCGAGACCG -> CTACCGTGCGCGAGACCGA
CCTACGACGATCCACTCGA -> CTACGACGATCCACTCGAA
CCTAGATACGCTCCACTAA -> CTAGATACGCTCCACTAAA
CCTATATCTTGGGGGGATG -> CTATATCTTGGGGGGATGA
CCTATGCCTGTTCCGCCGG -> CTATGCCTGTTCCGCCGGA
CCTCAAGACTGTGGAGCAC -> CTCAAGACTGTGGAGCACG
CCTCACGTCCAGTTTGGTG -> CTCACGTCCAGTTTGGTGC
CCTCACGTGTGCGTTTGCA -> CTCACGTGTGCGTTTGCAG
CCTCAGCCCAACGATAACG -> CTCAGCCCAACGATAACGC
CCTCATGCAGTTTGCAGGT -> CTCATGCAGTTTGCAGGTG
CCTCGTGGTCTGGCGTAGA -> CTCGTGGTCTGGCGTAGAG
CCTCTATGTCGTAGGCAGG -> CTCTATGTCGTAGGCAGGG
CCTCTTTACCTAGATACGC -> CTCTTTACCTAGATACGCT
CCTCTTTCCCCTAAGCAGT -> CTCTTTCCCCTAAGCAGTC
CCTGACCGCTCGTACCGAT -> CTGACCGCTCGTACCGATG
CCTGCCGCGAAATGCCTGC -> CTGCCGCGAAATGCCTGCC
CCTGCCGCGAATTTTCAAG -> CTGCCGCGAATTTTCAAGG
CCTGCCGCGACCAATTGTA -> CTGCCGCGACCAATTGTAA
CCTGCCGCGATAGGTCCTT -> CTGCCGCGATAGGTCCTTG
CCTGGACGCCAGGAGGAGC -> CTGGACGCCAGGAGGAGCC
CCTGGCAGCGATCCCACAA -> CTGGCAGCGATCCCACAAG
CCTGGGGCTGCACACGGAT -> CTGGGGCTGCACACGGATG
CCTGTCATTGCCTACCGTG -> CTGTCATTGCCTACCGTGC
CCTGTTCCGCCGGATTCTC -> CTGTTCCGCCGGATTCTCG
CCTTAAGCACCCTCAGCCC -> CTTAAGCACCCTCAGCCCA
CCTTAATCGCACGCGTAAG -> CTTAATCGCACGCGTAAGG
CCTTACAATACCTCACGTG -> CTTACAATACCTCACGTGT
CCTTAGGCTTTGCGTTTTG -> CTTAGGCTTTGCGTTTTGC
CCTTCCGCGAAACAGAAGA -> CTTCCGCGAAACAGAAGAG
CCTTGAGTCCATGATAGGA -> CTTGAGTCCATGATAGGAT
CCTTGCAAGGATGCAGCAA -> CTTGCAAGGATGCAGCAAC
CCTTGCCCCATTTCATTGC -> CTTGCCCCATTTCATTGCT
CCTTGGTGTTTGCGACGGA -> CTTGGTGTTTGCGACGGAT
CCTTTAGCTGAGTCTTCTC -> CTTTAGCTGAGTCTTCTCA
CCTTTCATCCCTGGCAGCG -> CTTTCATCCCTGGCAGCGA
CGAAACAGAAGAGTTCTTA -> GAAACAGAAGAGTTCTTAT
CGAAATGCCTGCCGCGAAT -> GAAATGCCTGCCGCGAATT
CGAAATGTGTATTACGTAG -> GAAATGTGTATTACGTAGG
CGAACCATTATGGCGTGCT -> GAACCATTATGGCGTGCTG
CGAACCGAGACTTACGATA -> GAACCGAGACTTACGATAT
CGAACCTTAAGCACCCTCA -> GAACCTTAAGCACCCTCAG
CGAAGCATGTTTGGCCCTG -> GAAGCATGTTTGGCCCTGG
CGAAGGCAAATTCGCCTCG -> GAAGGCAAATTCGCCTCGT
CGAAGTACTGTTGGTCGCG -> GAAGTACTGTTGGTCGCGA
CGAATCTACGTGAATAGCT -> GAATCTACGTGAATAGCTG
CGAATGACGACGGCTCGGC -> GAATGACGACGGCTCGGCC
CGAATTAATCCCTTTAGCT -> GAATTAATCCCTTTAGCTG
CGAATTTTCAAGGTTCCCG -> GAATTTTCAAGGTTCCCGT
CGACCAATTGTAAGCCCGC -> GACCAATTGTAAGCCCGCT
CGACCATGGCGCTTTGCCA -> GACCATGGCGCTTTGCCAA
CGACCGCTTGCACCAATTG -> GACCGCTTGCACCAATTGA
CGACGATCCACTCGAAGCA -> GACGATCCACTCGAAGCAT
CGACGGATTGTACCAACAC -> GACGGATTGTACCAACACT
CGACGGCTCGGCCGAGGTG -> GACGGCTCGGCCGAGGTGC
CGACTACCCTTCCGCGAAA -> GACTACCCTTCCGCGAAAC
CGACTCCAAATCAAAACTC -> GACTCCAAATCAAAACTCT
CGAGACCGAATTAATCCCT -> GAGACCGAATTAATCCCTT
CGAGACTTACGATATTCCG -> GAGACTTACGATATTCCGG
CGAGAGGAGCCTCTTTACC -> GAGAGGAGCCTCTTTACCT
CGAGCCCATCACCGGAAGG -> GAGCCCATCACCGGAAGGA
CGAGCGCATGTAGAAGTAC -> GAGCGCATGTAGAAGTACG
CGAGGTGCATTTTTTGTCG -> GAGGTGCATTTTTTGTCGT
CGAGGTTTTTACTGGGCTT -> GAGGTTTTTACTGGGCTTC
CGAGTACACTAAATGCCTG -> GAGTACACTAAATGCCTGC
CGATAACGCGAGCGCATGT -> GATAACGCGAGCGCATGTA
CGATAACTCGCCGTGAGCA -> GATAACTCGCCGTGAGCAA
CGATAAGCAACTCTTGAAA -> GATAAGCAACTCTTGAAAT
CGATAGGTCCTTGCCCCAT -> GATAGGTCCTTGCCCCATT
CGATATTCCGGTATAGTCG -> GATATTCCGGTATAGTCGT
CGATCCACTCGAAGCATGT -> GATCCACTCGAAGCATGTT
CGATCCCACAAGGTTCGGC -> GATCCCACAAGGTTCGGCA
CGATCCCAGTTAGGGATTG -> GATCCCAGTTAGGGATTGG
CGATCTCTTCTTTGTTGGA -> GATCTCTTCTTTGTTGGAA
CGATGGGTAGAAAAACATT -> GATGGGTAGAAAAACATTG
CGATGTTTGTCGTCGACCG -> GATGTTTGTCGTCGACCGC
CGATTAACGCCGAAGTACT -> GATTAACGCCGAAGTACTG
CGCACAATTATATCAGGCT -> GCACAATTATATCAGGCTT
CGCACGCGTAAGGCAGTAT -> GCACGCGTAAGGCAGTATG
CGCATAGAACATACCGTGT -> GCATAGAACATACCGTGTT
CGCATGTAGAAGTACGGGA -> GCATGTAGAAGTACGGGAA
CGCCAGGAGGAGCCAGGCG -> GCCAGGAGGAGCCAGGCGA
CGCCAGGTGAACTATTGTA -> GCCAGGTGAACTATTGTAT
CGCCAGTACTTTTGTCTGC -> GCCAGTACTTTTGTCTGCA
CGCCAGTCGTTTACAAATC -> GCCAGTCGTTTACAAATCA
CGCCAGTGTAGACTTGAAC -> GCCAGTGTAGACTTGAACA
CGCCAGTTATCACGAGTAC -> GCCAGTTATCACGAGTACA
CGCCGAAGTACTGTTGGTC -> GCCGAAGTACTGTTGGTCG
CGCCGGATTCTCGCGAGGT -> GCCGGATTCTCGCGAGGTT
CGCCGGGACTCTCTGAGCT -> GCCGGGACTCTCTGAGCTC
CGCCGTGAGCAATTTATGT -> GCCGTGAGCAATTTATGTC
CGCCTATGCCTGTTCCGCC -> GCCTATGCCTGTTCCGCCG
CGCCTCGTGGTCTGGCGTA -> GCCTCGTGGTCTGGCGTAG
CGCCTCTATGTCGTAGGCA -> GCCTCTATGTCGTAGGCAG
CGCCTTTCATCCCTGGCAG -> GCCTTTCATCCCTGGCAGC
CGCGAAACAGAAGAGTTCT -> GCGAAACAGAAGAGTTCTT
CGCGAAATGCCTGCCGCGA -> GCGAAATGCCTGCCGCGAA
CGCGAACCGAGACTTACGA -> GCGAACCGAGACTTACGAT
CGCGAATTTTCAAGGTTCC -> GCGAATTTTCAAGGTTCCC
CGCGACCAATTGTAAGCCC -> GCGACCAATTGTAAGCCCG
CGCGAGACCGAATTAATCC -> GCGAGACCGAATTAATCCC
CGCGAGCGCATGTAGAAGT -> GCGAGCGCATGTAGAAGTA
CGCGAGGTTTTTACTGGGC -> GCGAGGTTTTTACTGGGCT
CGCGATAACTCGCCGTGAG -> GCGATAACTCGCCGTGAGC
CGCGATAGGTCCTTGCCCC -> GCGATAGGTCCTTGCCCCA
CGCGATGTTTGTCGTCGAC -> GCGATGTTTGTCGTCGACC
CGCGTAAGGCAGTATGGAC -> GCGTAAGGCAGTATGGACG
CGCTAATAGGACAGACATT -> GCTAATAGGACAGACATTG
CGCTACGAATGACGACGGC -> GCTACGAATGACGACGGCT
CGCTCCACTAAAGCACTGT -> GCTCCACTAAAGCACTGTA
CGCTCGTACCGATGGGTAG -> GCTCGTACCGATGGGTAGA
CGCTTCAAACAGGTGCCCG -> GCTTCAAACAGGTGCCCGT
CGCTTGATGACTGACCTGT -> GCTTGATGACTGACCTGTC
CGCTTGCACCAATTGATCG -> GCTTGCACCAATTGATCGG
CGCTTTGCCAATACCACAA -> GCTTTGCCAATACCACAAC
CGGAACTGGCGAGCCCATC -> GGAACTGGCGAGCCCATCA
CGGAAGGAAGAAATTCCTC -> GGAAGGAAGAAATTCCTCA
CGGACGTGCCTTGCAAGGA -> GGACGTGCCTTGCAAGGAT
CGGACTATCGTTAAAACTT -> GGACTATCGTTAAAACTTT
CGGACTGCCGTGTTATGCA -> GGACTGCCGTGTTATGCAG
CGGATGAGATATCGCTTCA -> GGATGAGATATCGCTTCAA
CGGATTCTCGCGAGGTTTT -> GGATTCTCGCGAGGTTTTT
CGGATTGTACCAACACTCC -> GGATTGTACCAACACTCCT
CGGCACTGGCATCCACTTA -> GGCACTGGCATCCACTTAG
CGGCCGAGGTGCATTTTTT -> GGCCGAGGTGCATTTTTTG
CGGCGTAGGCCTTAGGCTT -> GGCGTAGGCCTTAGGCTTT
CGGCTCGGCCGAGGTGCAT -> GGCTCGGCCGAGGTGCATT
CGGCTGTCCCCACTTTTCC -> GGCTGTCCCCACTTTTCCA
CGGGAAAGGTGAATTCTCG -> GGGAAAGGTGAATTCTCGG
CGGGAACCTTGGTGTTTGC -> GGGAACCTTGGTGTTTGCG
CGGGAATACCAGTTTTCAA -> GGGAATACCAGTTTTCAAT
CGGGACTCTCTGAGCTCTG -> GGGACTCTCTGAGCTCTGA
CGGGCATTGAAACGTCGGG -> GGGCATTGAAACGTCGGGT
CGGGCGCCAGTACTTTTGT -> GGGCGCCAGTACTTTTGTC
CGGGCGCCAGTCGTTTACA -> GGGCGCCAGTCGTTTACAA
CGGGCGCCAGTGTAGACTT -> GGGCGCCAGTGTAGACTTG
CGGGCGCCAGTTATCACGA -> GGGCGCCAGTTATCACGAG
CGGGCGGGGGCGGGTTAAG -> GGGCGGGGGCGGGTTAAGA
CGGGCGTCCGAGAGGAGCC -> GGGCGTCCGAGAGGAGCCT
CGGGCTAACCAAACTGTAG -> GGGCTAACCAAACTGTAGA
CGGGGGCGGGTTAAGAACG -> GGGGGCGGGTTAAGAACGG
CGGGTAACGAAGGCAAATT -> GGGTAACGAAGGCAAATTC
CGGGTCCGGACTATCGTTA -> GGGTCCGGACTATCGTTAA
CGGGTTAAGAACGGTCCGG -> GGGTTAAGAACGGTCCGGG
CGGGTTTTTTCGGGCATTG -> GGGTTTTTTCGGGCATTGA
CGGTACAACAGCGCTAATA -> GGTACAACAGCGCTAATAG
CGGTATAGTCGTACGCACA -> GGTATAGTCGTACGCACAA
CGGTCCGGGAATACCAGTT -> GGTCCGGGAATACCAGTTT
CGGTCGTGATCAAAAACAG -> GGTCGTGATCAAAAACAGG
CGTAAGGCAGTATGGACGC -> GTAAGGCAGTATGGACGCA
CGTACCGATGGGTAGAAAA -> GTACCGATGGGTAGAAAAA
CGTACGCACAATTATATCA -> GTACGCACAATTATATCAG
CGTAGAGTTATACAGTTGA -> GTAGAGTTATACAGTTGAA
CGTAGCAGCCACGAAATGT -> GTAGCAGCCACGAAATGTG
CGTAGGCAGGGGTCGTAGC -> GTAGGCAGGGGTCGTAGCA
CGTAGGCCTTAGGCTTTGC -> GTAGGCCTTAGGCTTTGCG
CGTAGGTGAACCGTTTGGA -> GTAGGTGAACCGTTTGGAT
CGTATCTGGCCGGGCGCCA -> GTATCTGGCCGGGCGCCAG
CGTCAAATTCCTCTTTCCC -> GTCAAATTCCTCTTTCCCC
CGTCATTCTCGTTGTAAAT -> GTCATTCTCGTTGTAAATT
CGTCCAGTTTGGTGCGATA -> GTCCAGTTTGGTGCGATAA
CGTCCCCATAGCCTCACGT -> GTCCCCATAGCCTCACGTC
CGTCCGAGAGGAGCCTCTT -> GTCCGAGAGGAGCCTCTTT
CGTCGACCGCTTGCACCAA -> GTCGACCGCTTGCACCAAT
CGTCGGGTCCGGACTATCG -> GTCGGGTCCGGACTATCGT
CGTGAATAGCTGTTGGCTT -> GTGAATAGCTGTTGGCTTG
CGTGAGCAATTTATGTCCC -> GTGAGCAATTTATGTCCCG
CGTGATCAAAAACAGGCTA -> GTGATCAAAAACAGGCTAC
CGTGCCTTGCAAGGATGCA -> GTGCCTTGCAAGGATGCAG
CGTGCGCGAGACCGAATTA -> GTGCGCGAGACCGAATTAA
CGTGCTGATGTTTTTCGCC -> GTGCTGATGTTTTTCGCCT
CGTGGTCTGGCGTAGAGTT -> GTGGTCTGGCGTAGAGTTA
CGTGTGCGTTTGCAGGCTT -> GTGTGCGTTTGCAGGCTTG
CGTGTTATGCAGTAGATTG -> GTGTTATGCAGTAGATTGG
CGTGTTTTTCGTCCCCATA -> GTGTTTTTCGTCCCCATAG
CGTTAAAACTTTTTCCCAG -> GTTAAAACTTTTTCCCAGG
CGTTATCATCTGGCCGGGC -> GTTATCATCTGGCCGGGCG
CGTTCGCTTGATGACTGAC -> GTTCGCTTGATGACTGACC
CGTTCTGTAGAAGGCGGTA -> GTTCTGTAGAAGGCGGTAC
CGTTGCCTACGACGATCCA -> GTTGCCTACGACGATCCAC
CGTTGGGAGTAAACGACTA -> GTTGGGAGTAAACGACTAC
CGTTGTAAATTTCCCGATC -> GTTGTAAATTTCCCGATCC
CGTTTACAAATCACTAAAT -> GTTTACAAATCACTAAATG
CGTTTGCAGGCTTGCCCCA -> GTTTGCAGGCTTGCCCCAT
CGTTTGGATGCTTGCGTCA -> GTTTGGATGCTTGCGTCAT
CGTTTTGCCGGGTTTTTTC -> GTTTTGCCGGGTTTTTTCG
CTAAACGCCGGGACTCTCT -> TAAACGCCGGGACTCTCTG
CTAAAGCACTGTAATCTGG -> TAAAGCACTGTAATCTGGC
CTAAAGGGTTGAAGACAGT -> TAAAGGGTTGAAGACAGTA
CTAAATCGGCTGTCCCCAC -> TAAATCGGCTGTCCCCACT
CTAAATGCCTGCCGCGAAA -> TAAATGCCTGCCGCGAAAT
CTAAATGCCTGCCGCGACC -> TAAATGCCTGCCGCGACCA
CTAAATGCCTGCCGCGATA -> TAAATGCCTGCCGCGATAG
CTAACCAAACTGTAGACAT -> TAACCAAACTGTAGACATG
CTAACGGCGTAGGCCTTAG -> TAACGGCGTAGGCCTTAGG
CTAACGTTGCCTACGACGA -> TAACGTTGCCTACGACGAT
CTAAGCAGTCTCAAACCCC -> TAAGCAGTCTCAAACCCCG
CTAAGTTACCAAATATTCC -> TAAGTTACCAAATATTCCA
CTAATAGGACAGACATTGT -> TAATAGGACAGACATTGTG
CTACAGTTTCTAACGGCGT -> TACAGTTTCTAACGGCGTA
CTACCCTTCCGCGAAACAG -> TACCCTTCCGCGAAACAGA
CTACCGTGCGCGAGACCGA -> TACCGTGCGCGAGACCGAA
CTACGAATGACGACGGCTC -> TACGAATGACGACGGCTCG
CTACGACGATCCACTCGAA -> TACGACGATCCACTCGAAG
CTACGTGAATAGCTGTTGG -> TACGTGAATAGCTGTTGGC
CTACTCAGAAACGGAACTG -> TACTCAGAAACGGAACTGG
CTAGATACGCTCCACTAAA -> TAGATACGCTCCACTAAAG
CTAGATCTGGCCGGGCGCC -> TAGATCTGGCCGGGCGCCA
CTATATCTTGGGGGGATGA -> TATATCTTGGGGGGATGAC
CTATCGTTAAAACTTTTTC -> TATCGTTAAAACTTTTTCC
CTATGCCTGTTCCGCCGGA -> TATGCCTGTTCCGCCGGAT
CTATGTCGTAGGCAGGGGT -> TATGTCGTAGGCAGGGGTC
CTATTGTATGATCGGGCGG -> TATTGTATGATCGGGCGGG
CTCAAACCCCGGGAAAGGT -> TCAAACCCCGGGAAAGGTG
CTCAAGACTGTGGAGCACG -> TCAAGACTGTGGAGCACGG
CTCACGTCCAGTTTGGTGC -> TCACGTCCAGTTTGGTGCG
CTCACGTGTGCGTTTGCAG -> TCACGTGTGCGTTTGCAGG
CTCAGAAACGGAACTGGCG -> TCAGAAACGGAACTGGCGA
CTCAGCCCAACGATAACGC -> TCAGCCCAACGATAACGCG
CTCATCCGATCTCTTCTTT -> TCATCCGATCTCTTCTTTG
CTCATGCAGTTTGCAGGTG -> TCATGCAGTTTGCAGGTGG
CTCATTCCTATATCTTGGG -> TCATTCCTATATCTTGGGG
CTCCAAATCAAAACTCTTG -> TCCAAATCAAAACTCTTGC
CTCCACTAAAGCACTGTAA -> TCCACTAAAGCACTGTAAT
CTCCTTGAGTCCATGATAG -> TCCTTGAGTCCATGATAGG
CTCGAACCTTAAGCACCCT -> TCGAACCTTAAGCACCCTC
CTCGAAGCATGTTTGGCCC -> TCGAAGCATGTTTGGCCCT
CTCGCCGTGAGCAATTTAT -> TCGCCGTGAGCAATTTATG
CTCGCGAGGTTTTTACTGG -> TCGCGAGGTTTTTACTGGG
CTCGGCCGAGGTGCATTTT -> TCGGCCGAGGTGCATTTTT
CTCGGGCTAACCAAACTGT -> TCGGGCTAACCAAACTGTA
CTCGTACCGATGGGTAGAA -> TCGTACCGATGGGTAGAAA
CTCGTGGTCTGGCGTAGAG -> TCGTGGTCTGGCGTAGAGT
CTCGTTGTAAATTTCCCGA -> TCGTTGTAAATTTCCCGAT
CTCTATGTCGTAGGCAGGG -> TCTATGTCGTAGGCAGGGG
CTCTCTGAGCTCTGATCCG -> TCTCTGAGCTCTGATCCGT
CTCTGAGCTCTGATCCGTT -> TCTGAGCTCTGATCCGTTC
CTCTGATCCGTTCGCTTGA -> TCTGATCCGTTCGCTTGAT
CTCTTAGCTAACGTTGCCT -> TCTTAGCTAACGTTGCCTA
CTCTTCTTTGTTGGAACAG -> TCTTCTTTGTTGGAACAGG
CTCTTGAAATATTCCGTTA -> TCTTGAAATATTCCGTTAT
CTCTTGCTTGCCCAGGGGC -> TCTTGCTTGCCCAGGGGCC
CTCTTTACCTAGATACGCT -> TCTTTACCTAGATACGCTC
CTCTTTCCCCTAAGCAGTC -> TCTTTCCCCTAAGCAGTCT
CTGACCGCTCGTACCGATG -> TGACCGCTCGTACCGATGG
CTGACCTGTCATTGCCTAC -> TGACCTGTCATTGCCTACC
CTGAGCTCTGATCCGTTCG -> TGAGCTCTGATCCGTTCGC
CTGAGTCTTCTCATTCCTA -> TGAGTCTTCTCATTCCTAT
CTGATCCGTTCGCTTGATG -> TGATCCGTTCGCTTGATGA
CTGATGTTTTTCGCCTCTA -> TGATGTTTTTCGCCTCTAT
CTGCACACGGATGAGATAT -> TGCACACGGATGAGATATC
CTGCACTAGATCTGGCCGG -> TGCACTAGATCTGGCCGGG
CTGCCGCGAAATGCCTGCC -> TGCCGCGAAATGCCTGCCG
CTGCCGCGAATTTTCAAGG -> TGCCGCGAATTTTCAAGGT
CTGCCGCGACCAATTGTAA -> TGCCGCGACCAATTGTAAG
CTGCCGCGATAGGTCCTTG -> TGCCGCGATAGGTCCTTGC
CTGCCGTGTTATGCAGTAG -> TGCCGTGTTATGCAGTAGA
CTGCTAAATCGGCTGTCCC -> TGCTAAATCGGCTGTCCCC
CTGCTTAGGTTGCCAGGAG -> TGCTTAGGTTGCCAGGAGA
CTGGACGCCAGGAGGAGCC -> TGGACGCCAGGAGGAGCCA
CTGGCAGCGATCCCACAAG -> TGGCAGCGATCCCACAAGG
CTGGCATCCACTTAGTGCA -> TGGCATCCACTTAGTGCAG
CTGGCCGGGCGCCAGTACT -> TGGCCGGGCGCCAGTACTT
CTGGCCGGGCGCCAGTCGT -> TGGCCGGGCGCCAGTCGTT
CTGGCCGGGCGCCAGTGTA -> TGGCCGGGCGCCAGTGTAG
CTGGCCGGGCGCCAGTTAT -> TGGCCGGGCGCCAGTTATC
CTGGCGAGCCCATCACCGG -> TGGCGAGCCCATCACCGGA
CTGGCGTAGAGTTATACAG -> TGGCGTAGAGTTATACAGT
CTGGGCTTCTAAGTTACCA -> TGGGCTTCTAAGTTACCAA
CTGGGGCTGCACACGGATG -> TGGGGCTGCACACGGATGA
CTGTAATCTGGCCGGGCGC -> TGTAATCTGGCCGGGCGCC
CTGTAGAAGGCGGTACAAC -> TGTAGAAGGCGGTACAACA
CTGTAGACATGAGATGGTA -> TGTAGACATGAGATGGTAA
CTGTCATTGCCTACCGTGC -> TGTCATTGCCTACCGTGCG
CTGTCCCCACTTTTCCAAA -> TGTCCCCACTTTTCCAAAT
CTGTGGAGCACGGACGTGC -> TGTGGAGCACGGACGTGCC
CTGTTCCGCCGGATTCTCG -> TGTTCCGCCGGATTCTCGC
CTGTTGGCTTGGTTCGCGA -> TGTTGGCTTGGTTCGCGAT
CTGTTGGTCGCGATGTTTG -> TGTTGGTCGCGATGTTTGT
CTTAAGCACCCTCAGCCCA -> TTAAGCACCCTCAGCCCAA
CTTAATCGCACGCGTAAGG -> TTAATCGCACGCGTAAGGC
CTTACAATACCTCACGTGT -> TTACAATACCTCACGTGTG
CTTACGATATTCCGGTATA -> TTACGATATTCCGGTATAG
CTTAGCTAACGTTGCCTAC -> TTAGCTAACGTTGCCTACG
CTTAGGCTTTGCGTTTTGC -> TTAGGCTTTGCGTTTTGCC
CTTAGGTTGCCAGGAGAAC -> TTAGGTTGCCAGGAGAACC
CTTAGTGCAGCTTGCATTC -> TTAGTGCAGCTTGCATTCC
CTTATTACTAAACGCCGGG -> TTATTACTAAACGCCGGGA
CTTCAAACAGGTGCCCGTT -> TTCAAACAGGTGCCCGTTC
CTTCCGCGAAACAGAAGAG -> TTCCGCGAAACAGAAGAGT
CTTCCGGGCGTCCGAGAGG -> TTCCGGGCGTCCGAGAGGA
CTTCTAAGTTACCAAATAT -> TTCTAAGTTACCAAATATT
CTTCTCATTCCTATATCTT -> TTCTCATTCCTATATCTTG
CTTCTTTGTTGGAACAGGG -> TTCTTTGTTGGAACAGGGC
CTTGAAATATTCCGTTATC -> TTGAAATATTCCGTTATCA
CTTGAACACTAAATGCCTG -> TTGAACACTAAATGCCTGC
CTTGAGTCCATGATAGGAT -> TTGAGTCCATGATAGGATT
CTTGATGACTGACCTGTCA -> TTGATGACTGACCTGTCAT
CTTGCAAGGATGCAGCAAC -> TTGCAAGGATGCAGCAACA
CTTGCACCAATTGATCGGA -> TTGCACCAATTGATCGGAC
CTTGCATTCCTGACCGCTC -> TTGCATTCCTGACCGCTCG
CTTGCCCAGGGGCCTGGAC -> TTGCCCAGGGGCCTGGACG
CTTGCCCCATTATCCACTG -> TTGCCCCATTATCCACTGC
CTTGCCCCATTTCATTGCT -> TTGCCCCATTTCATTGCTG
CTTGCGTCATTCTCGTTGT -> TTGCGTCATTCTCGTTGTA
CTTGCTTGCCCAGGGGCCT -> TTGCTTGCCCAGGGGCCTG
CTTGGGGGGATGACTTTCG -> TTGGGGGGATGACTTTCGG
CTTGGGTCCTTAATCGCAC -> TTGGGTCCTTAATCGCACG
CTTGGTGTTTGCGACGGAT -> TTGGTGTTTGCGACGGATT
CTTGGTTCGCGATAACTCG -> TTGGTTCGCGATAACTCGC
CTTGTTCAGGTTCCGATTA -> TTGTTCAGGTTCCGATTAA
CTTTACCTAGATACGCTCC -> TTTACCTAGATACGCTCCA
CTTTAGCTGAGTCTTCTCA -> TTTAGCTGAGTCTTCTCAT
CTTTCAAGACTTGGGTCCT -> TTTCAAGACTTGGGTCCTT
CTTTCATCCCTGGCAGCGA -> TTTCATCCCTGGCAGCGAT
CTTTCCCCTAAGCAGTCTC -> TTTCCCCTAAGCAGTCTCA
CTTTCGGGTAACGAAGGCA -> TTTCGGGTAACGAAGGCAA
CTTTGCCAATACCACAACT -> TTTGCCAATACCACAACTT
CTTTGCGTTTTGCCGGGTT -> TTTGCGTTTTGCCGGGTTT
CTTTGTTGGAACAGGGCCC -> TTTGTTGGAACAGGGCCCC
CTTTTCCAAATGGATGTAC -> TTTTCCAAATGGATGTACC
CTTTTGTCTGCACTAGATC -> TTTTGTCTGCACTAGATCT
CTTTTTCCCAGGGTTCGCC -> TTTTTCCCAGGGTTCGCCA
CTTTTTTCGCCTATGCCTG -> TTTTTTCGCCTATGCCTGT
GAAAAACATTGTATGCTCA -> AAAAACATTGTATGCTCAT
GAAACAGAAGAGTTCTTAT -> AAACAGAAGAGTTCTTATT
GAAACGGAACTGGCGAGCC -> AAACGGAACTGGCGAGCCC
GAAACGTCGGGTCCGGACT -> AAACGTCGGGTCCGGACTA
GAAACTAAAGGGTTGAAGA -> AAACTAAAGGGTTGAAGAC
GAAAGGTGAATTCTCGGGC -> AAAGGTGAATTCTCGGGCT
GAAATATTCCGTTATCATC -> AAATATTCCGTTATCATCT
GAAATGCCTGCCGCGAATT -> AAATGCCTGCCGCGAATTT
GAAATGTGTATTACGTAGG -> AAATGTGTATTACGTAGGT
GAAATTCCTCATGCAGTTT -> AAATTCCTCATGCAGTTTG
GAACACTAAATGCCTGCCG -> AACACTAAATGCCTGCCGC
GAACAGGGCCCCGTCAAAT -> AACAGGGCCCCGTCAAATT
GAACATACCGTGTTTTTCG -> AACATACCGTGTTTTTCGT
GAACCATTATGGCGTGCTG -> AACCATTATGGCGTGCTGA
GAACCGAGACTTACGATAT -> AACCGAGACTTACGATATT
GAACCGGTCGTGATCAAAA -> AACCGGTCGTGATCAAAAA
GAACCGTTTGGATGCTTGC -> AACCGTTTGGATGCTTGCG
GAACCTTAAGCACCCTCAG -> AACCTTAAGCACCCTCAGC
GAACCTTGGTGTTTGCGAC -> AACCTTGGTGTTTGCGACG
GAACGGTCCGGGAATACCA -> AACGGTCCGGGAATACCAG
GAACTATTGTATGATCGGG -> AACTATTGTATGATCGGGC
GAACTGGCGAGCCCATCAC -> AACTGGCGAGCCCATCACC
GAAGAAATTCCTCATGCAG -> AAGAAATTCCTCATGCAGT
GAAGACAGTAAGTCAGTTC -> AAGACAGTAAGTCAGTTCA
GAAGAGTTCTTATTACTAA -> AAGAGTTCTTATTACTAAA
GAAGCATGTTTGGCCCTGG -> AAGCATGTTTGGCCCTGGG
GAAGGAAGAAATTCCTCAT -> AAGGAAGAAATTCCTCATG
GAAGGCAAATTCGCCTCGT -> AAGGCAAATTCGCCTCGTG
GAAGGCGGTACAACAGCGC -> AAGGCGGTACAACAGCGCT
GAAGTACGGGAACCTTGGT -> AAGTACGGGAACCTTGGTG
GAAGTACTGTTGGTCGCGA -> AAGTACTGTTGGTCGCGAT
GAATACCAGTTTTCAATGG -> AATACCAGTTTTCAATGGA
GAATAGCTGTTGGCTTGGT -> AATAGCTGTTGGCTTGGTT
GAATCTACGTGAATAGCTG -> AATCTACGTGAATAGCTGT
GAATGACGACGGCTCGGCC -> AATGACGACGGCTCGGCCG
GAATTAATCCCTTTAGCTG -> AATTAATCCCTTTAGCTGA
GAATTCTCGGGCTAACCAA -> AATTCTCGGGCTAACCAAA
GAATTTTCAAGGTTCCCGT -> AATTTTCAAGGTTCCCGTA
GACAGACATTGTGGCTTGT -> ACAGACATTGTGGCTTGTT
GACAGTAAGTCAGTTCAGT -> ACAGTAAGTCAGTTCAGTG
GACATGAGATGGTAACTCT -> ACATGAGATGGTAACTCTT
GACATTGTGGCTTGTTCAG -> ACATTGTGGCTTGTTCAGG
GACCAATTGTAAGCCCGCT -> ACCAATTGTAAGCCCGCTA
GACCATGGCGCTTTGCCAA -> ACCATGGCGCTTTGCCAAT
GACCGAATTAATCCCTTTA -> ACCGAATTAATCCCTTTAG
GACCGCTCGTACCGATGGG -> ACCGCTCGTACCGATGGGT
GACCGCTTGCACCAATTGA -> ACCGCTTGCACCAATTGAT
GACCTGTCATTGCCTACCG -> ACCTGTCATTGCCTACCGT
GACGACGGCTCGGCCGAGG -> ACGACGGCTCGGCCGAGGT
GACGATCCACTCGAAGCAT -> ACGATCCACTCGAAGCATG
GACGCATAGAACATACCGT -> ACGCATAGAACATACCGTG
GACGCCAGGAGGAGCCAGG -> ACGCCAGGAGGAGCCAGGC
GACGCCTTTCATCCCTGGC -> ACGCCTTTCATCCCTGGCA
GACGGATTGTACCAACACT -> ACGGATTGTACCAACACTC
GACGGCTCGGCCGAGGTGC -> ACGGCTCGGCCGAGGTGCA
GACGTGCCTTGCAAGGATG -> ACGTGCCTTGCAAGGATGC
GACTACCCTTCCGCGAAAC -> ACTACCCTTCCGCGAAACA
GACTATCGTTAAAACTTTT -> ACTATCGTTAAAACTTTTT
GACTCCAAATCAAAACTCT -> ACTCCAAATCAAAACTCTT
GACTCTCTGAGCTCTGATC -> ACTCTCTGAGCTCTGATCC
GACTGACCTGTCATTGCCT -> ACTGACCTGTCATTGCCTA
GACTGCCGTGTTATGCAGT -> ACTGCCGTGTTATGCAGTA
GACTGTGGAGCACGGACGT -> ACTGTGGAGCACGGACGTG
GACTTACGATATTCCGGTA -> ACTTACGATATTCCGGTAT
GACTTGAACACTAAATGCC -> ACTTGAACACTAAATGCCT
GACTTGGGTCCTTAATCGC -> ACTTGGGTCCTTAATCGCA
GACTTTCGGGTAACGAAGG -> ACTTTCGGGTAACGAAGGC
GAGAACCGGTCGTGATCAA -> AGAACCGGTCGTGATCAAA
GAGACCGAATTAATCCCTT -> AGACCGAATTAATCCCTTT
GAGACTTACGATATTCCGG -> AGACTTACGATATTCCGGT
GAGAGGAGCCTCTTTACCT -> AGAGGAGCCTCTTTACCTA
GAGATATCGCTTCAAACAG -> AGATATCGCTTCAAACAGG
GAGATGGTAACTCTTAGCT -> AGATGGTAACTCTTAGCTA
GAGCAATTTATGTCCCGAT -> AGCAATTTATGTCCCGATC
GAGCACGGACGTGCCTTGC -> AGCACGGACGTGCCTTGCA
GAGCCAGGCGAACCATTAT -> AGCCAGGCGAACCATTATG
GAGCCCATCACCGGAAGGA -> AGCCCATCACCGGAAGGAA
GAGCCTCTTTACCTAGATA -> AGCCTCTTTACCTAGATAC
GAGCGCATGTAGAAGTACG -> AGCGCATGTAGAAGTACGG
GAGCTCTGATCCGTTCGCT -> AGCTCTGATCCGTTCGCTT
GAGGAGCCAGGCGAACCAT -> AGGAGCCAGGCGAACCATT
GAGGAGCCTCTTTACCTAG -> AGGAGCCTCTTTACCTAGA
GAGGTGCATTTTTTGTCGT -> AGGTGCATTTTTTGTCGTT
GAGGTTTTTACTGGGCTTC -> AGGTTTTTACTGGGCTTCT
GAGTAAACGACTACCCTTC -> AGTAAACGACTACCCTTCC
GAGTACACTAAATGCCTGC -> AGTACACTAAATGCCTGCC
GAGTCCATGATAGGATTCT -> AGTCCATGATAGGATTCTT
GAGTCTTCTCATTCCTATA -> AGTCTTCTCATTCCTATAT
GAGTTATACAGTTGAAACT -> AGTTATACAGTTGAAACTA
GAGTTCTCGAACCTTAAGC -> AGTTCTCGAACCTTAAGCA
GAGTTCTTATTACTAAACG -> AGTTCTTATTACTAAACGC
GATAACGCGAGCGCATGTA -> ATAACGCGAGCGCATGTAG
GATAACTCGCCGTGAGCAA -> ATAACTCGCCGTGAGCAAT
GATAAGCAACTCTTGAAAT -> ATAAGCAACTCTTGAAATA
GATACGCTCCACTAAAGCA -> ATACGCTCCACTAAAGCAC
GATAGGATTCTTCCGGGCG -> ATAGGATTCTTCCGGGCGT
GATAGGTCCTTGCCCCATT -> ATAGGTCCTTGCCCCATTT
GATATCGCTTCAAACAGGT -> ATATCGCTTCAAACAGGTG
GATATTCCGGTATAGTCGT -> ATATTCCGGTATAGTCGTA
GATCAAAAACAGGCTACTC -> ATCAAAAACAGGCTACTCA
GATCCACTCGAAGCATGTT -> ATCCACTCGAAGCATGTTT
GATCCCACAAGGTTCGGCA -> ATCCCACAAGGTTCGGCAC
GATCCCAGTTAGGGATTGG -> ATCCCAGTTAGGGATTGGA
GATCCGTTCGCTTGATGAC -> ATCCGTTCGCTTGATGACT
GATCGGACTGCCGTGTTAT -> ATCGGACTGCCGTGTTATG
GATCGGGCGGGGGCGGGTT -> ATCGGGCGGGGGCGGGTTA
GATCTCTTCTTTGTTGGAA -> ATCTCTTCTTTGTTGGAAC
GATCTGGCCGGGCGCCAGT -> ATCTGGCCGGGCGCCAGTG
GATGACTGACCTGTCATTG -> ATGACTGACCTGTCATTGC
GATGACTTTCGGGTAACGA -> ATGACTTTCGGGTAACGAA
GATGAGATATCGCTTCAAA -> ATGAGATATCGCTTCAAAC
GATGCAGCAACACGAATCT -> ATGCAGCAACACGAATCTA
GATGCTTGCGTCATTCTCG -> ATGCTTGCGTCATTCTCGT
GATGGGTAGAAAAACATTG -> ATGGGTAGAAAAACATTGT
GATGGTAACTCTTAGCTAA -> ATGGTAACTCTTAGCTAAC
GATGGTTTACGCGAACCGA -> ATGGTTTACGCGAACCGAG
GATGTACCTCAAGACTGTG -> ATGTACCTCAAGACTGTGG
GATGTTTGTCGTCGACCGC -> ATGTTTGTCGTCGACCGCT
GATGTTTTTCGCCTCTATG -> ATGTTTTTCGCCTCTATGT
GATTAACGCCGAAGTACTG -> ATTAACGCCGAAGTACTGT
GATTCTCGCGAGGTTTTTA -> ATTCTCGCGAGGTTTTTAC
GATTCTTCCGGGCGTCCGA -> ATTCTTCCGGGCGTCCGAG
GATTGGACGCCTTTCATCC -> ATTGGACGCCTTTCATCCC
GATTGGTAGTGCCTTACAA -> ATTGGTAGTGCCTTACAAT
GATTGTACCAACACTCCTT -> ATTGTACCAACACTCCTTG
GCAAACACGACTCCAAATC -> CAAACACGACTCCAAATCA
GCAAATTCGCCTCGTGGTC -> CAAATTCGCCTCGTGGTCT
GCAACACGAATCTACGTGA -> CAACACGAATCTACGTGAA
GCAACTCTTGAAATATTCC -> CAACTCTTGAAATATTCCG
GCAAGGATGCAGCAACACG -> CAAGGATGCAGCAACACGA
GCAATTTATGTCCCGATCG -> CAATTTATGTCCCGATCGT
GCACAATTATATCAGGCTT -> CACAATTATATCAGGCTTT
GCACACGGATGAGATATCG -> CACACGGATGAGATATCGC
GCACCAATTGATCGGACTG -> CACCAATTGATCGGACTGC
GCACCCTCAGCCCAACGAT -> CACCCTCAGCCCAACGATA
GCACGCGTAAGGCAGTATG -> CACGCGTAAGGCAGTATGG
GCACGGACGTGCCTTGCAA -> CACGGACGTGCCTTGCAAG
GCACTAGATCTGGCCGGGC -> CACTAGATCTGGCCGGGCG
GCACTGGCATCCACTTAGT -> CACTGGCATCCACTTAGTG
GCACTGTAATCTGGCCGGG -> CACTGTAATCTGGCCGGGC
GCAGCAACACGAATCTACG -> CAGCAACACGAATCTACGT
GCAGCCACGAAATGTGTAT -> CAGCCACGAAATGTGTATT
GCAGCGATCCCACAAGGTT -> CAGCGATCCCACAAGGTTC
GCAGCTTGCATTCCTGACC -> CAGCTTGCATTCCTGACCG
GCAGGCTTGCCCCATTATC -> CAGGCTTGCCCCATTATCC
GCAGGGGTCGTAGCAGCCA -> CAGGGGTCGTAGCAGCCAC
GCAGGTGGGTTTCGACCAT -> CAGGTGGGTTTCGACCATG
GCAGTAGATTGGTAGTGCC -> CAGTAGATTGGTAGTGCCT
GCAGTATGGACGCATAGAA -> CAGTATGGACGCATAGAAC
GCAGTCTCAAACCCCGGGA -> CAGTCTCAAACCCCGGGAA
GCAGTTTGCAGGTGGGTTT -> CAGTTTGCAGGTGGGTTTC
GCATAGAACATACCGTGTT -> CATAGAACATACCGTGTTT
GCATCCACTTAGTGCAGCT -> CATCCACTTAGTGCAGCTT
GCATGTAGAAGTACGGGAA -> CATGTAGAAGTACGGGAAC
GCATGTTTGGCCCTGGGGC -> CATGTTTGGCCCTGGGGCT
GCATTCCTGACCGCTCGTA -> CATTCCTGACCGCTCGTAC
GCATTGAAACGTCGGGTCC -> CATTGAAACGTCGGGTCCG
GCATTTTTTGTCGTTGGGA -> CATTTTTTGTCGTTGGGAG
GCCAATACCACAACTTTTT -> CCAATACCACAACTTTTTT
GCCACGAAATGTGTATTAC -> CCACGAAATGTGTATTACG
GCCAGGAGAACCGGTCGTG -> CCAGGAGAACCGGTCGTGA
GCCAGGAGGAGCCAGGCGA -> CCAGGAGGAGCCAGGCGAA
GCCAGGCGAACCATTATGG -> CCAGGCGAACCATTATGGC
GCCAGGTGAACTATTGTAT -> CCAGGTGAACTATTGTATG
GCCAGTACTTTTGTCTGCA -> CCAGTACTTTTGTCTGCAC
GCCAGTCGTTTACAAATCA -> CCAGTCGTTTACAAATCAC
GCCAGTGTAGACTTGAACA -> CCAGTGTAGACTTGAACAC
GCCAGTTATCACGAGTACA -> CCAGTTATCACGAGTACAC
GCCCAACGATAACGCGAGC -> CCCAACGATAACGCGAGCG
GCCCAGGGGCCTGGACGCC -> CCCAGGGGCCTGGACGCCA
GCCCATCACCGGAAGGAAG -> CCCATCACCGGAAGGAAGA
GCCCCATTATCCACTGCTT -> CCCCATTATCCACTGCTTA
GCCCCATTTCATTGCTGCT -> CCCCATTTCATTGCTGCTA
GCCCCGTCAAATTCCTCTT -> CCCCGTCAAATTCCTCTTT
GCCCGCTACGAATGACGAC -> CCCGCTACGAATGACGACG
GCCCGTTCTGTAGAAGGCG -> CCCGTTCTGTAGAAGGCGG
GCCCTGGGGCTGCACACGG -> CCCTGGGGCTGCACACGGA
GCCGAAGTACTGTTGGTCG -> CCGAAGTACTGTTGGTCGC
GCCGAGGTGCATTTTTTGT -> CCGAGGTGCATTTTTTGTC
GCCGCGAAATGCCTGCCGC -> CCGCGAAATGCCTGCCGCG
GCCGCGAATTTTCAAGGTT -> CCGCGAATTTTCAAGGTTC
GCCGCGACCAATTGTAAGC -> CCGCGACCAATTGTAAGCC
GCCGCGATAGGTCCTTGCC -> CCGCGATAGGTCCTTGCCC
GCCGGATTCTCGCGAGGTT -> CCGGATTCTCGCGAGGTTT
GCCGGGACTCTCTGAGCTC -> CCGGGACTCTCTGAGCTCT
GCCGGGCGCCAGTACTTTT -> CCGGGCGCCAGTACTTTTG
GCCGGGCGCCAGTCGTTTA -> CCGGGCGCCAGTCGTTTAC
GCCGGGCGCCAGTGTAGAC -> CCGGGCGCCAGTGTAGACT
GCCGGGCGCCAGTTATCAC -> CCGGGCGCCAGTTATCACG
GCCGGGTTTTTTCGGGCAT -> CCGGGTTTTTTCGGGCATT
GCCGTGAGCAATTTATGTC -> CCGTGAGCAATTTATGTCC
GCCGTGTTATGCAGTAGAT -> CCGTGTTATGCAGTAGATT
GCCTACCGTGCGCGAGACC -> CCTACCGTGCGCGAGACCG
GCCTACGACGATCCACTCG -> CCTACGACGATCCACTCGA
GCCTATGCCTGTTCCGCCG -> CCTATGCCTGTTCCGCCGG
GCCTCACGTCCAGTTTGGT -> CCTCACGTCCAGTTTGGTG
GCCTCGTGGTCTGGCGTAG -> CCTCGTGGTCTGGCGTAGA
GCCTCTATGTCGTAGGCAG -> CCTCTATGTCGTAGGCAGG
GCCTCTTTACCTAGATACG -> CCTCTTTACCTAGATACGC
GCCTGCCGCGAAATGCCTG -> CCTGCCGCGAAATGCCTGC
GCCTGCCGCGAATTTTCAA -> CCTGCCGCGAATTTTCAAG
GCCTGCCGCGACCAATTGT -> CCTGCCGCGACCAATTGTA
GCCTGCCGCGATAGGTCCT -> CCTGCCGCGATAGGTCCTT
GCCTGGACGCCAGGAGGAG -> CCTGGACGCCAGGAGGAGC
GCCTGTTCCGCCGGATTCT -> CCTGTTCCGCCGGATTCTC
GCCTTACAATACCTCACGT -> CCTTACAATACCTCACGTG
GCCTTAGGCTTTGCGTTTT -> CCTTAGGCTTTGCGTTTTG
GCCTTGCAAGGATGCAGCA -> CCTTGCAAGGATGCAGCAA
GCCTTTCATCCCTGGCAGC -> CCTTTCATCCCTGGCAGCG
GCGAAACAGAAGAGTTCTT -> CGAAACAGAAGAGTTCTTA
GCGAAATGCCTGCCGCGAA -> CGAAATGCCTGCCGCGAAT
GCGAACCATTATGGCGTGC -> CGAACCATTATGGCGTGCT
GCGAACCGAGACTTACGAT -> CGAACCGAGACTTACGATA
GCGAATTTTCAAGGTTCCC -> CGAATTTTCAAGGTTCCCG
GCGACCAATTGTAAGCCCG -> CGACCAATTGTAAGCCCGC
GCGACGGATTGTACCAACA -> CGACGGATTGTACCAACAC
GCGAGACCGAATTAATCCC -> CGAGACCGAATTAATCCCT
GCGAGCCCATCACCGGAAG -> CGAGCCCATCACCGGAAGG
GCGAGCGCATGTAGAAGTA -> CGAGCGCATGTAGAAGTAC
GCGAGGTTTTTACTGGGCT -> CGAGGTTTTTACTGGGCTT
GCGATAACTCGCCGTGAGC -> CGATAACTCGCCGTGAGCA
GCGATAAGCAACTCTTGAA -> CGATAAGCAACTCTTGAAA
GCGATAGGTCCTTGCCCCA -> CGATAGGTCCTTGCCCCAT
GCGATCCCACAAGGTTCGG -> CGATCCCACAAGGTTCGGC
GCGATGTTTGTCGTCGACC -> CGATGTTTGTCGTCGACCG
GCGCATGTAGAAGTACGGG -> CGCATGTAGAAGTACGGGA
GCGCCAGTACTTTTGTCTG -> CGCCAGTACTTTTGTCTGC
GCGCCAGTCGTTTACAAAT -> CGCCAGTCGTTTACAAATC
GCGCCAGTGTAGACTTGAA -> CGCCAGTGTAGACTTGAAC
GCGCCAGTTATCACGAGTA -> CGCCAGTTATCACGAGTAC
GCGCGAGACCGAATTAATC -> CGCGAGACCGAATTAATCC
GCGCTAATAGGACAGACAT -> CGCTAATAGGACAGACATT
GCGCTTTGCCAATACCACA -> CGCTTTGCCAATACCACAA
GCGGGGGCGGGTTAAGAAC -> CGGGGGCGGGTTAAGAACG
GCGGGTTAAGAACGGTCCG -> CGGGTTAAGAACGGTCCGG
GCGGTACAACAGCGCTAAT -> CGGTACAACAGCGCTAATA
GCGTAAGGCAGTATGGACG -> CGTAAGGCAGTATGGACGC
GCGTAGAGTTATACAGTTG -> CGTAGAGTTATACAGTTGA
GCGTAGGCCTTAGGCTTTG -> CGTAGGCCTTAGGCTTTGC
GCGTCATTCTCGTTGTAAA -> CGTCATTCTCGTTGTAAAT
GCGTCCGAGAGGAGCCTCT -> CGTCCGAGAGGAGCCTCTT
GCGTGCTGATGTTTTTCGC -> CGTGCTGATGTTTTTCGCC
GCGTTTGCAGGCTTGCCCC -> CGTTTGCAGGCTTGCCCCA
GCGTTTTGCCGGGTTTTTT -> CGTTTTGCCGGGTTTTTTC
GCTAAATCGGCTGTCCCCA -> CTAAATCGGCTGTCCCCAC
GCTAACCAAACTGTAGACA -> CTAACCAAACTGTAGACAT
GCTAACGTTGCCTACGACG -> CTAACGTTGCCTACGACGA
GCTAATAGGACAGACATTG -> CTAATAGGACAGACATTGT
GCTACGAATGACGACGGCT -> CTACGAATGACGACGGCTC
GCTACTCAGAAACGGAACT -> CTACTCAGAAACGGAACTG
GCTCATCCGATCTCTTCTT -> CTCATCCGATCTCTTCTTT
GCTCCACTAAAGCACTGTA -> CTCCACTAAAGCACTGTAA
GCTCGGCCGAGGTGCATTT -> CTCGGCCGAGGTGCATTTT
GCTCGTACCGATGGGTAGA -> CTCGTACCGATGGGTAGAA
GCTCTGATCCGTTCGCTTG -> CTCTGATCCGTTCGCTTGA
GCTGAGTCTTCTCATTCCT -> CTGAGTCTTCTCATTCCTA
GCTGATGTTTTTCGCCTCT -> CTGATGTTTTTCGCCTCTA
GCTGCACACGGATGAGATA -> CTGCACACGGATGAGATAT
GCTGCTAAATCGGCTGTCC -> CTGCTAAATCGGCTGTCCC
GCTGTCCCCACTTTTCCAA -> CTGTCCCCACTTTTCCAAA
GCTGTTGGCTTGGTTCGCG -> CTGTTGGCTTGGTTCGCGA
GCTTAGGTTGCCAGGAGAA -> CTTAGGTTGCCAGGAGAAC
GCTTCAAACAGGTGCCCGT -> CTTCAAACAGGTGCCCGTT
GCTTCTAAGTTACCAAATA -> CTTCTAAGTTACCAAATAT
GCTTGATGACTGACCTGTC -> CTTGATGACTGACCTGTCA
GCTTGCACCAATTGATCGG -> CTTGCACCAATTGATCGGA
GCTTGCATTCCTGACCGCT -> CTTGCATTCCTGACCGCTC
GCTTGCCCAGGGGCCTGGA -> CTTGCCCAGGGGCCTGGAC
GCTTGCCCCATTATCCACT -> CTTGCCCCATTATCCACTG
GCTTGCGTCATTCTCGTTG -> CTTGCGTCATTCTCGTTGT
GCTTGGTTCGCGATAACTC -> CTTGGTTCGCGATAACTCG
GCTTGTTCAGGTTCCGATT -> CTTGTTCAGGTTCCGATTA
GCTTTCAAGACTTGGGTCC -> CTTTCAAGACTTGGGTCCT
GCTTTGCCAATACCACAAC -> CTTTGCCAATACCACAACT
GCTTTGCGTTTTGCCGGGT -> CTTTGCGTTTTGCCGGGTT
GGAAAGGTGAATTCTCGGG -> GAAAGGTGAATTCTCGGGC
GGAACAGGGCCCCGTCAAA -> GAACAGGGCCCCGTCAAAT
GGAACCTTGGTGTTTGCGA -> GAACCTTGGTGTTTGCGAC
GGAACTGGCGAGCCCATCA -> GAACTGGCGAGCCCATCAC
GGAAGAAATTCCTCATGCA -> GAAGAAATTCCTCATGCAG
GGAAGGAAGAAATTCCTCA -> GAAGGAAGAAATTCCTCAT
GGAATACCAGTTTTCAATG -> GAATACCAGTTTTCAATGG
GGACAGACATTGTGGCTTG -> GACAGACATTGTGGCTTGT
GGACGCATAGAACATACCG -> GACGCATAGAACATACCGT
GGACGCCAGGAGGAGCCAG -> GACGCCAGGAGGAGCCAGG
GGACGCCTTTCATCCCTGG -> GACGCCTTTCATCCCTGGC
GGACGTGCCTTGCAAGGAT -> GACGTGCCTTGCAAGGATG
GGACTATCGTTAAAACTTT -> GACTATCGTTAAAACTTTT
GGACTCTCTGAGCTCTGAT -> GACTCTCTGAGCTCTGATC
GGACTGCCGTGTTATGCAG -> GACTGCCGTGTTATGCAGT
GGAGAACCGGTCGTGATCA -> GAGAACCGGTCGTGATCAA
GGAGCACGGACGTGCCTTG -> GAGCACGGACGTGCCTTGC
GGAGCCAGGCGAACCATTA -> GAGCCAGGCGAACCATTAT
GGAGCCTCTTTACCTAGAT -> GAGCCTCTTTACCTAGATA
GGAGGAGCCAGGCGAACCA -> GAGGAGCCAGGCGAACCAT
GGAGTAAACGACTACCCTT -> GAGTAAACGACTACCCTTC
GGATGACTTTCGGGTAACG -> GATGACTTTCGGGTAACGA
GGATGAGATATCGCTTCAA -> GATGAGATATCGCTTCAAA
GGATGCAGCAACACGAATC -> GATGCAGCAACACGAATCT
GGATGCTTGCGTCATTCTC -> GATGCTTGCGTCATTCTCG
GGATGGTTTACGCGAACCG -> GATGGTTTACGCGAACCGA
GGATGTACCTCAAGACTGT -> GATGTACCTCAAGACTGTG
GGATTCTCGCGAGGTTTTT -> GATTCTCGCGAGGTTTTTA
GGATTCTTCCGGGCGTCCG -> GATTCTTCCGGGCGTCCGA
GGATTGGACGCCTTTCATC -> GATTGGACGCCTTTCATCC
GGATTGTACCAACACTCCT -> GATTGTACCAACACTCCTT
GGCAAATTCGCCTCGTGGT -> GCAAATTCGCCTCGTGGTC
GGCACTGGCATCCACTTAG -> GCACTGGCATCCACTTAGT
GGCAGCGATCCCACAAGGT -> GCAGCGATCCCACAAGGTT
GGCAGGGGTCGTAGCAGCC -> GCAGGGGTCGTAGCAGCCA
GGCAGTATGGACGCATAGA -> GCAGTATGGACGCATAGAA
GGCATCCACTTAGTGCAGC -> GCATCCACTTAGTGCAGCT
GGCATTGAAACGTCGGGTC -> GCATTGAAACGTCGGGTCC
GGCCCCGTCAAATTCCTCT -> GCCCCGTCAAATTCCTCTT
GGCCCTGGGGCTGCACACG -> GCCCTGGGGCTGCACACGG
GGCCGAGGTGCATTTTTTG -> GCCGAGGTGCATTTTTTGT
GGCCGGGCGCCAGTACTTT -> GCCGGGCGCCAGTACTTTT
GGCCGGGCGCCAGTCGTTT -> GCCGGGCGCCAGTCGTTTA
GGCCGGGCGCCAGTGTAGA -> GCCGGGCGCCAGTGTAGAC
GGCCGGGCGCCAGTTATCA -> GCCGGGCGCCAGTTATCAC
GGCCTGGACGCCAGGAGGA -> GCCTGGACGCCAGGAGGAG
GGCCTTAGGCTTTGCGTTT -> GCCTTAGGCTTTGCGTTTT
GGCGAACCATTATGGCGTG -> GCGAACCATTATGGCGTGC
GGCGAGCCCATCACCGGAA -> GCGAGCCCATCACCGGAAG
GGCGCCAGTACTTTTGTCT -> GCGCCAGTACTTTTGTCTG
GGCGCCAGTCGTTTACAAA -> GCGCCAGTCGTTTACAAAT
GGCGCCAGTGTAGACTTGA -> GCGCCAGTGTAGACTTGAA
GGCGCCAGTTATCACGAGT -> GCGCCAGTTATCACGAGTA
GGCGCTTTGCCAATACCAC -> GCGCTTTGCCAATACCACA
GGCGGGGGCGGGTTAAGAA -> GCGGGGGCGGGTTAAGAAC
GGCGGGTTAAGAACGGTCC -> GCGGGTTAAGAACGGTCCG
GGCGGTACAACAGCGCTAA -> GCGGTACAACAGCGCTAAT
GGCGTAGAGTTATACAGTT -> GCGTAGAGTTATACAGTTG
GGCGTAGGCCTTAGGCTTT -> GCGTAGGCCTTAGGCTTTG
GGCGTCCGAGAGGAGCCTC -> GCGTCCGAGAGGAGCCTCT
GGCGTGCTGATGTTTTTCG -> GCGTGCTGATGTTTTTCGC
GGCTAACCAAACTGTAGAC -> GCTAACCAAACTGTAGACA
GGCTACTCAGAAACGGAAC -> GCTACTCAGAAACGGAACT
GGCTCGGCCGAGGTGCATT -> GCTCGGCCGAGGTGCATTT
GGCTGCACACGGATGAGAT -> GCTGCACACGGATGAGATA
GGCTGTCCCCACTTTTCCA -> GCTGTCCCCACTTTTCCAA
GGCTTCTAAGTTACCAAAT -> GCTTCTAAGTTACCAAATA
GGCTTGCCCCATTATCCAC -> GCTTGCCCCATTATCCACT
GGCTTGGTTCGCGATAACT -> GCTTGGTTCGCGATAACTC
GGCTTGTTCAGGTTCCGAT -> GCTTGTTCAGGTTCCGATT
GGCTTTCAAGACTTGGGTC -> GCTTTCAAGACTTGGGTCC
GGCTTTGCGTTTTGCCGGG -> GCTTTGCGTTTTGCCGGGT
GGGAAAGGTGAATTCTCGG -> GGAAAGGTGAATTCTCGGG
GGGAACCTTGGTGTTTGCG -> GGAACCTTGGTGTTTGCGA
GGGAATACCAGTTTTCAAT -> GGAATACCAGTTTTCAATG
GGGACTCTCTGAGCTCTGA -> GGACTCTCTGAGCTCTGAT
GGGAGTAAACGACTACCCT -> GGAGTAAACGACTACCCTT
GGGATGACTTTCGGGTAAC -> GGATGACTTTCGGGTAACG
GGGATTGGACGCCTTTCAT -> GGATTGGACGCCTTTCATC
GGGCATTGAAACGTCGGGT -> GGCATTGAAACGTCGGGTC
GGGCCCCGTCAAATTCCTC -> GGCCCCGTCAAATTCCTCT
GGGCCTGGACGCCAGGAGG -> GGCCTGGACGCCAGGAGGA
GGGCGCCAGTACTTTTGTC -> GGCGCCAGTACTTTTGTCT
GGGCGCCAGTCGTTTACAA -> GGCGCCAGTCGTTTACAAA
GGGCGCCAGTGTAGACTTG -> GGCGCCAGTGTAGACTTGA
GGGCGCCAGTTATCACGAG -> GGCGCCAGTTATCACGAGT
GGGCGGGGGCGGGTTAAGA -> GGCGGGGGCGGGTTAAGAA
GGGCGGGTTAAGAACGGTC -> GGCGGGTTAAGAACGGTCC
GGGCGTCCGAGAGGAGCCT -> GGCGTCCGAGAGGAGCCTC
GGGCTAACCAAACTGTAGA -> GGCTAACCAAACTGTAGAC
GGGCTGCACACGGATGAGA -> GGCTGCACACGGATGAGAT
GGGCTTCTAAGTTACCAAA -> GGCTTCTAAGTTACCAAAT
GGGGATGACTTTCGGGTAA -> GGGATGACTTTCGGGTAAC
GGGGCCTGGACGCCAGGAG -> GGGCCTGGACGCCAGGAGG
GGGGCGGGTTAAGAACGGT -> GGGCGGGTTAAGAACGGTC
GGGGCTGCACACGGATGAG -> GGGCTGCACACGGATGAGA
GGGGGATGACTTTCGGGTA -> GGGGATGACTTTCGGGTAA
GGGGGCGGGTTAAGAACGG -> GGGGCGGGTTAAGAACGGT
GGGGGGATGACTTTCGGGT -> GGGGGATGACTTTCGGGTA
GGGGTCGTAGCAGCCACGA -> GGGTCGTAGCAGCCACGAA
GGGTAACGAAGGCAAATTC -> GGTAACGAAGGCAAATTCG
GGGTAGAAAAACATTGTAT -> GGTAGAAAAACATTGTATG
GGGTCCGGACTATCGTTAA -> GGTCCGGACTATCGTTAAA
GGGTCCTTAATCGCACGCG -> GGTCCTTAATCGCACGCGT
GGGTCGTAGCAGCCACGAA -> GGTCGTAGCAGCCACGAAA
GGGTTAAGAACGGTCCGGG -> GGTTAAGAACGGTCCGGGA
GGGTTCGCCAGGTGAACTA -> GGTTCGCCAGGTGAACTAT
GGGTTGAAGACAGTAAGTC -> GGTTGAAGACAGTAAGTCA
GGGTTTCGACCATGGCGCT -> GGTTTCGACCATGGCGCTT
GGGTTTTTTCGGGCATTGA -> GGTTTTTTCGGGCATTGAA
GGTAACGAAGGCAAATTCG -> GTAACGAAGGCAAATTCGC
GGTAACTCTTAGCTAACGT -> GTAACTCTTAGCTAACGTT
GGTACAACAGCGCTAATAG -> GTACAACAGCGCTAATAGG
GGTAGAAAAACATTGTATG -> GTAGAAAAACATTGTATGC
GGTAGTGCCTTACAATACC -> GTAGTGCCTTACAATACCT
GGTATAGTCGTACGCACAA -> GTATAGTCGTACGCACAAT
GGTCCGGACTATCGTTAAA -> GTCCGGACTATCGTTAAAA
GGTCCGGGAATACCAGTTT -> GTCCGGGAATACCAGTTTT
GGTCCTTAATCGCACGCGT -> GTCCTTAATCGCACGCGTA
GGTCCTTGCCCCATTTCAT -> GTCCTTGCCCCATTTCATT
GGTCGCGATGTTTGTCGTC -> GTCGCGATGTTTGTCGTCG
GGTCGTAGCAGCCACGAAA -> GTCGTAGCAGCCACGAAAT
GGTCGTGATCAAAAACAGG -> GTCGTGATCAAAAACAGGC
GGTCTGGCGTAGAGTTATA -> GTCTGGCGTAGAGTTATAC
GGTGAACCGTTTGGATGCT -> GTGAACCGTTTGGATGCTT
GGTGAACTATTGTATGATC -> GTGAACTATTGTATGATCG
GGTGAATTCTCGGGCTAAC -> GTGAATTCTCGGGCTAACC
GGTGCATTTTTTGTCGTTG -> GTGCATTTTTTGTCGTTGG
GGTGCCCGTTCTGTAGAAG -> GTGCCCGTTCTGTAGAAGG
GGTGCGATAAGCAACTCTT -> GTGCGATAAGCAACTCTTG
GGTGGGTTTCGACCATGGC -> GTGGGTTTCGACCATGGCG
GGTGTTTGCGACGGATTGT -> GTGTTTGCGACGGATTGTA
GGTTAAGAACGGTCCGGGA -> GTTAAGAACGGTCCGGGAA
GGTTCCCGTATCTGGCCGG -> GTTCCCGTATCTGGCCGGG
GGTTCCGATTAACGCCGAA -> GTTCCGATTAACGCCGAAG
GGTTCGCCAGGTGAACTAT -> GTTCGCCAGGTGAACTATT
GGTTCGCGATAACTCGCCG -> GTTCGCGATAACTCGCCGT
GGTTCGGCACTGGCATCCA -> GTTCGGCACTGGCATCCAC
GGTTGAAGACAGTAAGTCA -> GTTGAAGACAGTAAGTCAG
GGTTGCCAGGAGAACCGGT -> GTTGCCAGGAGAACCGGTC
GGTTTACGCGAACCGAGAC -> GTTTACGCGAACCGAGACT
GGTTTCGACCATGGCGCTT -> GTTTCGACCATGGCGCTTT
GGTTTTTACTGGGCTTCTA -> GTTTTTACTGGGCTTCTAA
GGTTTTTTCGGGCATTGAA -> GTTTTTTCGGGCATTGAAA
GTAAACGACTACCCTTCCG -> TAAACGACTACCCTTCCGC
GTAAATTTCCCGATCCCAG -> TAAATTTCCCGATCCCAGT
GTAACGAAGGCAAATTCGC -> TAACGAAGGCAAATTCGCC
GTAACTCTTAGCTAACGTT -> TAACTCTTAGCTAACGTTG
GTAAGCCCGCTACGAATGA -> TAAGCCCGCTACGAATGAC
GTAAGGCAGTATGGACGCA -> TAAGGCAGTATGGACGCAT
GTAAGTCAGTTCAGTGCAA -> TAAGTCAGTTCAGTGCAAA
GTAATCTGGCCGGGCGCCA -> TAATCTGGCCGGGCGCCAG
GTACAACAGCGCTAATAGG -> TACAACAGCGCTAATAGGA
GTACACTAAATGCCTGCCG -> TACACTAAATGCCTGCCGC
GTACCAACACTCCTTGAGT -> TACCAACACTCCTTGAGTC
GTACCGATGGGTAGAAAAA -> TACCGATGGGTAGAAAAAC
GTACCTCAAGACTGTGGAG -> TACCTCAAGACTGTGGAGC
GTACGCACAATTATATCAG -> TACGCACAATTATATCAGG
GTACGGGAACCTTGGTGTT -> TACGGGAACCTTGGTGTTT
GTACTGTTGGTCGCGATGT -> TACTGTTGGTCGCGATGTT
GTACTTTTGTCTGCACTAG -> TACTTTTGTCTGCACTAGA
GTAGAAAAACATTGTATGC -> TAGAAAAACATTGTATGCT
GTAGAAGGCGGTACAACAG -> TAGAAGGCGGTACAACAGC
GTAGAAGTACGGGAACCTT -> TAGAAGTACGGGAACCTTG
GTAGACATGAGATGGTAAC -> TAGACATGAGATGGTAACT
GTAGACTTGAACACTAAAT -> TAGACTTGAACACTAAATG
GTAGAGTTATACAGTTGAA -> TAGAGTTATACAGTTGAAA
GTAGATTGGTAGTGCCTTA -> TAGATTGGTAGTGCCTTAC
GTAGCAGCCACGAAATGTG -> TAGCAGCCACGAAATGTGT
GTAGGCAGGGGTCGTAGCA -> TAGGCAGGGGTCGTAGCAG
GTAGGCCTTAGGCTTTGCG -> TAGGCCTTAGGCTTTGCGT
GTAGGTGAACCGTTTGGAT -> TAGGTGAACCGTTTGGATG
GTAGTGCCTTACAATACCT -> TAGTGCCTTACAATACCTC
GTATAGTCGTACGCACAAT -> TATAGTCGTACGCACAATT
GTATCTGGCCGGGCGCCAG -> TATCTGGCCGGGCGCCAGT
GTATGATCGGGCGGGGGCG -> TATGATCGGGCGGGGGCGG
GTATGCTCATCCGATCTCT -> TATGCTCATCCGATCTCTT
GTATGGACGCATAGAACAT -> TATGGACGCATAGAACATA
GTATTACGTAGGTGAACCG -> TATTACGTAGGTGAACCGT
GTCAAATTCCTCTTTCCCC -> TCAAATTCCTCTTTCCCCT
GTCAGTTCAGTGCAAACAC -> TCAGTTCAGTGCAAACACG
GTCATTCTCGTTGTAAATT -> TCATTCTCGTTGTAAATTT
GTCATTGCCTACCGTGCGC -> TCATTGCCTACCGTGCGCG
GTCCAGTTTGGTGCGATAA -> TCCAGTTTGGTGCGATAAG
GTCCATGATAGGATTCTTC -> TCCATGATAGGATTCTTCC
GTCCCCACTTTTCCAAATG -> TCCCCACTTTTCCAAATGG
GTCCCCATAGCCTCACGTC -> TCCCCATAGCCTCACGTCC
GTCCGAGAGGAGCCTCTTT -> TCCGAGAGGAGCCTCTTTA
GTCCGGACTATCGTTAAAA -> TCCGGACTATCGTTAAAAC
GTCCGGGAATACCAGTTTT -> TCCGGGAATACCAGTTTTC
GTCCTTAATCGCACGCGTA -> TCCTTAATCGCACGCGTAA
GTCCTTGCCCCATTTCATT -> TCCTTGCCCCATTTCATTG
GTCGACCGCTTGCACCAAT -> TCGACCGCTTGCACCAATT
GTCGCGATGTTTGTCGTCG -> TCGCGATGTTTGTCGTCGA
GTCGGGTCCGGACTATCGT -> TCGGGTCCGGACTATCGTT
GTCGTACGCACAATTATAT -> TCGTACGCACAATTATATC
GTCGTAGCAGCCACGAAAT -> TCGTAGCAGCCACGAAATG
GTCGTAGGCAGGGGTCGTA -> TCGTAGGCAGGGGTCGTAG
GTCGTCGACCGCTTGCACC -> TCGTCGACCGCTTGCACCA
GTCGTGATCAAAAACAGGC -> TCGTGATCAAAAACAGGCT
GTCGTTGGGAGTAAACGAC -> TCGTTGGGAGTAAACGACT
GTCGTTTACAAATCACTAA -> TCGTTTACAAATCACTAAA
GTCTCAAACCCCGGGAAAG -> TCTCAAACCCCGGGAAAGG
GTCTGCACTAGATCTGGCC -> TCTGCACTAGATCTGGCCG
GTCTGGCGTAGAGTTATAC -> TCTGGCGTAGAGTTATACA
GTCTTCTCATTCCTATATC -> TCTTCTCATTCCTATATCT
GTGAACCGTTTGGATGCTT -> TGAACCGTTTGGATGCTTG
GTGAACTATTGTATGATCG -> TGAACTATTGTATGATCGG
GTGAATAGCTGTTGGCTTG -> TGAATAGCTGTTGGCTTGG
GTGAATTCTCGGGCTAACC -> TGAATTCTCGGGCTAACCA
GTGAGCAATTTATGTCCCG -> TGAGCAATTTATGTCCCGA
GTGATCAAAAACAGGCTAC -> TGATCAAAAACAGGCTACT
GTGCAAACACGACTCCAAA -> TGCAAACACGACTCCAAAT
GTGCAGCTTGCATTCCTGA -> TGCAGCTTGCATTCCTGAC
GTGCATTTTTTGTCGTTGG -> TGCATTTTTTGTCGTTGGG
GTGCCCGTTCTGTAGAAGG -> TGCCCGTTCTGTAGAAGGC
GTGCCTTACAATACCTCAC -> TGCCTTACAATACCTCACG
GTGCCTTGCAAGGATGCAG -> TGCCTTGCAAGGATGCAGC
GTGCGATAAGCAACTCTTG -> TGCGATAAGCAACTCTTGA
GTGCGCGAGACCGAATTAA -> TGCGCGAGACCGAATTAAT
GTGCGTTTGCAGGCTTGCC -> TGCGTTTGCAGGCTTGCCC
GTGCTGATGTTTTTCGCCT -> TGCTGATGTTTTTCGCCTC
GTGGAGCACGGACGTGCCT -> TGGAGCACGGACGTGCCTT
GTGGCTTGTTCAGGTTCCG -> TGGCTTGTTCAGGTTCCGA
GTGGGTTTCGACCATGGCG -> TGGGTTTCGACCATGGCGC
GTGGTCTGGCGTAGAGTTA -> TGGTCTGGCGTAGAGTTAT
GTGTAGACTTGAACACTAA -> TGTAGACTTGAACACTAAA
GTGTATTACGTAGGTGAAC -> TGTATTACGTAGGTGAACC
GTGTGCGTTTGCAGGCTTG -> TGTGCGTTTGCAGGCTTGC
GTGTTATGCAGTAGATTGG -> TGTTATGCAGTAGATTGGT
GTGTTTGCGACGGATTGTA -> TGTTTGCGACGGATTGTAC
GTGTTTTTCGTCCCCATAG -> TGTTTTTCGTCCCCATAGC
GTTAAAACTTTTTCCCAGG -> TTAAAACTTTTTCCCAGGG
GTTAAGAACGGTCCGGGAA -> TTAAGAACGGTCCGGGAAT
GTTACCAAATATTCCACCC -> TTACCAAATATTCCACCCT
GTTAGGGATTGGACGCCTT -> TTAGGGATTGGACGCCTTT
GTTATACAGTTGAAACTAA -> TTATACAGTTGAAACTAAA
GTTATCACGAGTACACTAA -> TTATCACGAGTACACTAAA
GTTATCATCTGGCCGGGCG -> TTATCATCTGGCCGGGCGC
GTTATGCAGTAGATTGGTA -> TTATGCAGTAGATTGGTAG
GTTCAGGTTCCGATTAACG -> TTCAGGTTCCGATTAACGC
GTTCAGTGCAAACACGACT -> TTCAGTGCAAACACGACTC
GTTCCCGTATCTGGCCGGG -> TTCCCGTATCTGGCCGGGC
GTTCCGATTAACGCCGAAG -> TTCCGATTAACGCCGAAGT
GTTCCGCCGGATTCTCGCG -> TTCCGCCGGATTCTCGCGA
GTTCGCCAGGTGAACTATT -> TTCGCCAGGTGAACTATTG
GTTCGCGATAACTCGCCGT -> TTCGCGATAACTCGCCGTG
GTTCGCTTGATGACTGACC -> TTCGCTTGATGACTGACCT
GTTCGGCACTGGCATCCAC -> TTCGGCACTGGCATCCACT
GTTCTCGAACCTTAAGCAC -> TTCTCGAACCTTAAGCACC
GTTCTGTAGAAGGCGGTAC -> TTCTGTAGAAGGCGGTACA
GTTCTTATTACTAAACGCC -> TTCTTATTACTAAACGCCG
GTTGAAACTAAAGGGTTGA -> TTGAAACTAAAGGGTTGAA
GTTGAAGACAGTAAGTCAG -> TTGAAGACAGTAAGTCAGT
GTTGCCAGGAGAACCGGTC -> TTGCCAGGAGAACCGGTCG
GTTGCCTACGACGATCCAC -> TTGCCTACGACGATCCACT
GTTGGAACAGGGCCCCGTC -> TTGGAACAGGGCCCCGTCA
GTTGGCTTGGTTCGCGATA -> TTGGCTTGGTTCGCGATAA
GTTGGGAGTAAACGACTAC -> TTGGGAGTAAACGACTACC
GTTGGTCGCGATGTTTGTC -> TTGGTCGCGATGTTTGTCG
GTTGTAAATTTCCCGATCC -> TTGTAAATTTCCCGATCCC
GTTTACAAATCACTAAATG -> TTTACAAATCACTAAATGC
GTTTACGCGAACCGAGACT -> TTTACGCGAACCGAGACTT
GTTTCGACCATGGCGCTTT -> TTTCGACCATGGCGCTTTG
GTTTCTAACGGCGTAGGCC -> TTTCTAACGGCGTAGGCCT
GTTTGCAGGCTTGCCCCAT -> TTTGCAGGCTTGCCCCATT
GTTTGCAGGTGGGTTTCGA -> TTTGCAGGTGGGTTTCGAC
GTTTGCGACGGATTGTACC -> TTTGCGACGGATTGTACCA
GTTTGGATGCTTGCGTCAT -> TTTGGATGCTTGCGTCATT
GTTTGGCCCTGGGGCTGCA -> TTTGGCCCTGGGGCTGCAC
GTTTGGTGCGATAAGCAAC -> TTTGGTGCGATAAGCAACT
GTTTGTCGTCGACCGCTTG -> TTTGTCGTCGACCGCTTGC
GTTTTCAATGGATGGTTTA -> TTTTCAATGGATGGTTTAC
GTTTTGCCGGGTTTTTTCG -> TTTTGCCGGGTTTTTTCGG
GTTTTTACTGGGCTTCTAA -> TTTTTACTGGGCTTCTAAG
GTTTTTCGCCTCTATGTCG -> TTTTTCGCCTCTATGTCGT
GTTTTTCGTCCCCATAGCC -> TTTTTCGTCCCCATAGCCT
GTTTTTTCGGGCATTGAAA -> TTTTTTCGGGCATTGAAAC
TAAAACTTTTTCCCAGGGT -> AAAACTTTTTCCCAGGGTT
TAAACGACTACCCTTCCGC -> AAACGACTACCCTTCCGCG
TAAACGCCGGGACTCTCTG -> AAACGCCGGGACTCTCTGA
TAAAGCACTGTAATCTGGC -> AAAGCACTGTAATCTGGCC
TAAAGGGTTGAAGACAGTA -> AAAGGGTTGAAGACAGTAA
TAAATCGGCTGTCCCCACT -> AAATCGGCTGTCCCCACTT
TAAATGCCTGCCGCGAAAT -> AAATGCCTGCCGCGAAATG
TAAATGCCTGCCGCGACCA -> AAATGCCTGCCGCGACCAA
TAAATGCCTGCCGCGATAG -> AAATGCCTGCCGCGATAGG
TAAATTTCCCGATCCCAGT -> AAATTTCCCGATCCCAGTT
TAACCAAACTGTAGACATG -> AACCAAACTGTAGACATGA
TAACGAAGGCAAATTCGCC -> AACGAAGGCAAATTCGCCT
TAACGCCGAAGTACTGTTG -> AACGCCGAAGTACTGTTGG
TAACGCGAGCGCATGTAGA -> AACGCGAGCGCATGTAGAA
TAACGGCGTAGGCCTTAGG -> AACGGCGTAGGCCTTAGGC
TAACGTTGCCTACGACGAT -> AACGTTGCCTACGACGATC
TAACTCGCCGTGAGCAATT -> AACTCGCCGTGAGCAATTT
TAACTCTTAGCTAACGTTG -> AACTCTTAGCTAACGTTGC
TAAGAACGGTCCGGGAATA -> AAGAACGGTCCGGGAATAC
TAAGCAACTCTTGAAATAT -> AAGCAACTCTTGAAATATT
TAAGCACCCTCAGCCCAAC -> AAGCACCCTCAGCCCAACG
TAAGCAGTCTCAAACCCCG -> AAGCAGTCTCAAACCCCGG
TAAGCCCGCTACGAATGAC -> AAGCCCGCTACGAATGACG
TAAGGCAGTATGGACGCAT -> AAGGCAGTATGGACGCATA
TAAGTCAGTTCAGTGCAAA -> AAGTCAGTTCAGTGCAAAC
TAAGTTACCAAATATTCCA -> AAGTTACCAAATATTCCAC
TAATAGGACAGACATTGTG -> AATAGGACAGACATTGTGG
TAATCCCTTTAGCTGAGTC -> AATCCCTTTAGCTGAGTCT
TAATCGCACGCGTAAGGCA -> AATCGCACGCGTAAGGCAG
TAATCTGGCCGGGCGCCAG -> AATCTGGCCGGGCGCCAGT
TACAAATCACTAAATGCCT -> ACAAATCACTAAATGCCTG
TACAACAGCGCTAATAGGA -> ACAACAGCGCTAATAGGAC
TACAATACCTCACGTGTGC -> ACAATACCTCACGTGTGCG
TACACTAAATGCCTGCCGC -> ACACTAAATGCCTGCCGCG
TACAGTTGAAACTAAAGGG -> ACAGTTGAAACTAAAGGGT
TACAGTTTCTAACGGCGTA -> ACAGTTTCTAACGGCGTAG
TACCAAATATTCCACCCTA -> ACCAAATATTCCACCCTAC
TACCAACACTCCTTGAGTC -> ACCAACACTCCTTGAGTCC
TACCACAACTTTTTTCGCC -> ACCACAACTTTTTTCGCCT
TACCAGTTTTCAATGGATG -> ACCAGTTTTCAATGGATGG
TACCCTTCCGCGAAACAGA -> ACCCTTCCGCGAAACAGAA
TACCGATGGGTAGAAAAAC -> ACCGATGGGTAGAAAAACA
TACCGTGCGCGAGACCGAA -> ACCGTGCGCGAGACCGAAT
TACCGTGTTTTTCGTCCCC -> ACCGTGTTTTTCGTCCCCA
TACCTAGATACGCTCCACT -> ACCTAGATACGCTCCACTA
TACCTCAAGACTGTGGAGC -> ACCTCAAGACTGTGGAGCA
TACCTCACGTGTGCGTTTG -> ACCTCACGTGTGCGTTTGC
TACGAATGACGACGGCTCG -> ACGAATGACGACGGCTCGG
TACGACGATCCACTCGAAG -> ACGACGATCCACTCGAAGC
TACGATATTCCGGTATAGT -> ACGATATTCCGGTATAGTC
TACGCACAATTATATCAGG -> ACGCACAATTATATCAGGC
TACGCGAACCGAGACTTAC -> ACGCGAACCGAGACTTACG
TACGCTCCACTAAAGCACT -> ACGCTCCACTAAAGCACTG
TACGGGAACCTTGGTGTTT -> ACGGGAACCTTGGTGTTTG
TACGTAGGTGAACCGTTTG -> ACGTAGGTGAACCGTTTGG
TACGTGAATAGCTGTTGGC -> ACGTGAATAGCTGTTGGCT
TACTAAACGCCGGGACTCT -> ACTAAACGCCGGGACTCTC
TACTCAGAAACGGAACTGG -> ACTCAGAAACGGAACTGGC
TACTGGGCTTCTAAGTTAC -> ACTGGGCTTCTAAGTTACC
TACTGTTGGTCGCGATGTT -> ACTGTTGGTCGCGATGTTT
TACTTTTGTCTGCACTAGA -> ACTTTTGTCTGCACTAGAT
TAGAAAAACATTGTATGCT -> AGAAAAACATTGTATGCTC
TAGAACATACCGTGTTTTT -> AGAACATACCGTGTTTTTC
TAGAAGGCGGTACAACAGC -> AGAAGGCGGTACAACAGCG
TAGAAGTACGGGAACCTTG -> AGAAGTACGGGAACCTTGG
TAGACATGAGATGGTAACT -> AGACATGAGATGGTAACTC
TAGACTTGAACACTAAATG -> AGACTTGAACACTAAATGC
TAGAGTTATACAGTTGAAA -> AGAGTTATACAGTTGAAAC
TAGATACGCTCCACTAAAG -> AGATACGCTCCACTAAAGC
TAGATCTGGCCGGGCGCCA -> AGATCTGGCCGGGCGCCAG
TAGATTGGTAGTGCCTTAC -> AGATTGGTAGTGCCTTACA
TAGCAGCCACGAAATGTGT -> AGCAGCCACGAAATGTGTA
TAGCCTCACGTCCAGTTTG -> AGCCTCACGTCCAGTTTGG
TAGCTAACGTTGCCTACGA -> AGCTAACGTTGCCTACGAC
TAGCTGAGTCTTCTCATTC -> AGCTGAGTCTTCTCATTCC
TAGCTGTTGGCTTGGTTCG -> AGCTGTTGGCTTGGTTCGC
TAGGACAGACATTGTGGCT -> AGGACAGACATTGTGGCTT
TAGGATTCTTCCGGGCGTC -> AGGATTCTTCCGGGCGTCC
TAGGCAGGGGTCGTAGCAG -> AGGCAGGGGTCGTAGCAGC
TAGGCCTTAGGCTTTGCGT -> AGGCCTTAGGCTTTGCGTT
TAGGCTTTGCGTTTTGCCG -> AGGCTTTGCGTTTTGCCGG
TAGGGATTGGACGCCTTTC -> AGGGATTGGACGCCTTTCA
TAGGTCCTTGCCCCATTTC -> AGGTCCTTGCCCCATTTCA
TAGGTGAACCGTTTGGATG -> AGGTGAACCGTTTGGATGC
TAGGTTGCCAGGAGAACCG -> AGGTTGCCAGGAGAACCGG
TAGTCGTACGCACAATTAT -> AGTCGTACGCACAATTATA
TAGTGCAGCTTGCATTCCT -> AGTGCAGCTTGCATTCCTG
TAGTGCCTTACAATACCTC -> AGTGCCTTACAATACCTCA
TATACAGTTGAAACTAAAG -> ATACAGTTGAAACTAAAGG
TATAGTCGTACGCACAATT -> ATAGTCGTACGCACAATTA
TATATCAGGCTTTCAAGAC -> ATATCAGGCTTTCAAGACT
TATATCTTGGGGGGATGAC -> ATATCTTGGGGGGATGACT
TATCACGAGTACACTAAAT -> ATCACGAGTACACTAAATG
TATCAGGCTTTCAAGACTT -> ATCAGGCTTTCAAGACTTG
TATCATCTGGCCGGGCGCC -> ATCATCTGGCCGGGCGCCA
TATCCACTGCTTAGGTTGC -> ATCCACTGCTTAGGTTGCC
TATCGCTTCAAACAGGTGC -> ATCGCTTCAAACAGGTGCC
TATCGTTAAAACTTTTTCC -> ATCGTTAAAACTTTTTCCC
TATCTGGCCGGGCGCCAGT -> ATCTGGCCGGGCGCCAGTT
TATCTTGGGGGGATGACTT -> ATCTTGGGGGGATGACTTT
TATGATCGGGCGGGGGCGG -> ATGATCGGGCGGGGGCGGG
TATGCAGTAGATTGGTAGT -> ATGCAGTAGATTGGTAGTG
TATGCCTGTTCCGCCGGAT -> ATGCCTGTTCCGCCGGATT
TATGCTCATCCGATCTCTT -> ATGCTCATCCGATCTCTTC
TATGGACGCATAGAACATA -> ATGGACGCATAGAACATAC
TATGGCGTGCTGATGTTTT -> ATGGCGTGCTGATGTTTTT
TATGTCGTAGGCAGGGGTC -> ATGTCGTAGGCAGGGGTCG
TATTACGTAGGTGAACCGT -> ATTACGTAGGTGAACCGTT
TATTACTAAACGCCGGGAC -> ATTACTAAACGCCGGGACT
TATTCCACCCTACAGTTTC -> ATTCCACCCTACAGTTTCT
TATTCCGGTATAGTCGTAC -> ATTCCGGTATAGTCGTACG
TATTCCGTTATCATCTGGC -> ATTCCGTTATCATCTGGCC
TATTGTATGATCGGGCGGG -> ATTGTATGATCGGGCGGGG
TCAAAAACAGGCTACTCAG -> CAAAAACAGGCTACTCAGA
TCAAAACTCTTGCTTGCCC -> CAAAACTCTTGCTTGCCCA
TCAAACAGGTGCCCGTTCT -> CAAACAGGTGCCCGTTCTG
TCAAACCCCGGGAAAGGTG -> CAAACCCCGGGAAAGGTGA
TCAAATTCCTCTTTCCCCT -> CAAATTCCTCTTTCCCCTA
TCAAGACTGTGGAGCACGG -> CAAGACTGTGGAGCACGGA
TCAAGACTTGGGTCCTTAA -> CAAGACTTGGGTCCTTAAT
TCAAGGTTCCCGTATCTGG -> CAAGGTTCCCGTATCTGGC
TCAATGGATGGTTTACGCG -> CAATGGATGGTTTACGCGA
TCACCGGAAGGAAGAAATT -> CACCGGAAGGAAGAAATTC
TCACGAGTACACTAAATGC -> CACGAGTACACTAAATGCC
TCACGTCCAGTTTGGTGCG -> CACGTCCAGTTTGGTGCGA
TCACGTGTGCGTTTGCAGG -> CACGTGTGCGTTTGCAGGC
TCACTAAATGCCTGCCGCG -> CACTAAATGCCTGCCGCGA
TCAGAAACGGAACTGGCGA -> CAGAAACGGAACTGGCGAG
TCAGCCCAACGATAACGCG -> CAGCCCAACGATAACGCGA
TCAGGCTTTCAAGACTTGG -> CAGGCTTTCAAGACTTGGG
TCAGGTTCCGATTAACGCC -> CAGGTTCCGATTAACGCCG
TCAGTGCAAACACGACTCC -> CAGTGCAAACACGACTCCA
TCAGTTCAGTGCAAACACG -> CAGTTCAGTGCAAACACGA
TCATCCCTGGCAGCGATCC -> CATCCCTGGCAGCGATCCC
TCATCCGATCTCTTCTTTG -> CATCCGATCTCTTCTTTGT
TCATCTGGCCGGGCGCCAG -> CATCTGGCCGGGCGCCAGT
TCATGCAGTTTGCAGGTGG -> CATGCAGTTTGCAGGTGGG
TCATTCCTATATCTTGGGG -> CATTCCTATATCTTGGGGG
TCATTCTCGTTGTAAATTT -> CATTCTCGTTGTAAATTTC
TCATTGCCTACCGTGCGCG -> CATTGCCTACCGTGCGCGA
TCATTGCTGCTAAATCGGC -> CATTGCTGCTAAATCGGCT
TCCAAATCAAAACTCTTGC -> CCAAATCAAAACTCTTGCT
TCCAAATGGATGTACCTCA -> CCAAATGGATGTACCTCAA
TCCACCCTACAGTTTCTAA -> CCACCCTACAGTTTCTAAC
TCCACTAAAGCACTGTAAT -> CCACTAAAGCACTGTAATC
TCCACTCGAAGCATGTTTG -> CCACTCGAAGCATGTTTGG
TCCACTGCTTAGGTTGCCA -> CCACTGCTTAGGTTGCCAG
TCCACTTAGTGCAGCTTGC -> CCACTTAGTGCAGCTTGCA
TCCAGTTTGGTGCGATAAG -> CCAGTTTGGTGCGATAAGC
TCCATGATAGGATTCTTCC -> CCATGATAGGATTCTTCCG
TCCCACAAGGTTCGGCACT -> CCCACAAGGTTCGGCACTG
TCCCAGGGTTCGCCAGGTG -> CCCAGGGTTCGCCAGGTGA
TCCCAGTTAGGGATTGGAC -> CCCAGTTAGGGATTGGACG
TCCCCACTTTTCCAAATGG -> CCCCACTTTTCCAAATGGA
TCCCCATAGCCTCACGTCC -> CCCCATAGCCTCACGTCCA
TCCCCTAAGCAGTCTCAAA -> CCCCTAAGCAGTCTCAAAC
TCCCGATCCCAGTTAGGGA -> CCCGATCCCAGTTAGGGAT
TCCCGTATCTGGCCGGGCG -> CCCGTATCTGGCCGGGCGC
TCCCTGGCAGCGATCCCAC -> CCCTGGCAGCGATCCCACA
TCCCTTTAGCTGAGTCTTC -> CCCTTTAGCTGAGTCTTCT
TCCGAGAGGAGCCTCTTTA -> CCGAGAGGAGCCTCTTTAC
TCCGATCTCTTCTTTGTTG -> CCGATCTCTTCTTTGTTGG
TCCGATTAACGCCGAAGTA -> CCGATTAACGCCGAAGTAC
TCCGCCGGATTCTCGCGAG -> CCGCCGGATTCTCGCGAGG
TCCGCGAAACAGAAGAGTT -> CCGCGAAACAGAAGAGTTC
TCCGGACTATCGTTAAAAC -> CCGGACTATCGTTAAAACT
TCCGGGAATACCAGTTTTC -> CCGGGAATACCAGTTTTCA
TCCGGGCGTCCGAGAGGAG -> CCGGGCGTCCGAGAGGAGC
TCCGGTATAGTCGTACGCA -> CCGGTATAGTCGTACGCAC
TCCGTTATCATCTGGCCGG -> CCGTTATCATCTGGCCGGG
TCCGTTCGCTTGATGACTG -> CCGTTCGCTTGATGACTGA
TCCTATATCTTGGGGGGAT -> CCTATATCTTGGGGGGATG
TCCTCATGCAGTTTGCAGG -> CCTCATGCAGTTTGCAGGT
TCCTCTTTCCCCTAAGCAG -> CCTCTTTCCCCTAAGCAGT
TCCTGACCGCTCGTACCGA -> CCTGACCGCTCGTACCGAT
TCCTTAATCGCACGCGTAA -> CCTTAATCGCACGCGTAAG
TCCTTGAGTCCATGATAGG -> CCTTGAGTCCATGATAGGA
TCCTTGCCCCATTTCATTG -> CCTTGCCCCATTTCATTGC
TCGAACCTTAAGCACCCTC -> CGAACCTTAAGCACCCTCA
TCGAAGCATGTTTGGCCCT -> CGAAGCATGTTTGGCCCTG
TCGACCATGGCGCTTTGCC -> CGACCATGGCGCTTTGCCA
TCGACCGCTTGCACCAATT -> CGACCGCTTGCACCAATTG
TCGCACGCGTAAGGCAGTA -> CGCACGCGTAAGGCAGTAT
TCGCCAGGTGAACTATTGT -> CGCCAGGTGAACTATTGTA
TCGCCGTGAGCAATTTATG -> CGCCGTGAGCAATTTATGT
TCGCCTATGCCTGTTCCGC -> CGCCTATGCCTGTTCCGCC
TCGCCTCGTGGTCTGGCGT -> CGCCTCGTGGTCTGGCGTA
TCGCCTCTATGTCGTAGGC -> CGCCTCTATGTCGTAGGCA
TCGCGAGGTTTTTACTGGG -> CGCGAGGTTTTTACTGGGC
TCGCGATAACTCGCCGTGA -> CGCGATAACTCGCCGTGAG
TCGCGATGTTTGTCGTCGA -> CGCGATGTTTGTCGTCGAC
TCGCTTCAAACAGGTGCCC -> CGCTTCAAACAGGTGCCCG
TCGCTTGATGACTGACCTG -> CGCTTGATGACTGACCTGT
TCGGACTGCCGTGTTATGC -> CGGACTGCCGTGTTATGCA
TCGGCACTGGCATCCACTT -> CGGCACTGGCATCCACTTA
TCGGCCGAGGTGCATTTTT -> CGGCCGAGGTGCATTTTTT
TCGGCTGTCCCCACTTTTC -> CGGCTGTCCCCACTTTTCC
TCGGGCATTGAAACGTCGG -> CGGGCATTGAAACGTCGGG
TCGGGCGGGGGCGGGTTAA -> CGGGCGGGGGCGGGTTAAG
TCGGGCTAACCAAACTGTA -> CGGGCTAACCAAACTGTAG
TCGGGTAACGAAGGCAAAT -> CGGGTAACGAAGGCAAATT
TCGGGTCCGGACTATCGTT -> CGGGTCCGGACTATCGTTA
TCGTACCGATGGGTAGAAA -> CGTACCGATGGGTAGAAAA
TCGTACGCACAATTATATC -> CGTACGCACAATTATATCA
TCGTAGCAGCCACGAAATG -> CGTAGCAGCCACGAAATGT
TCGTAGGCAGGGGTCGTAG -> CGTAGGCAGGGGTCGTAGC
TCGTCCCCATAGCCTCACG -> CGTCCCCATAGCCTCACGT
TCGTCGACCGCTTGCACCA -> CGTCGACCGCTTGCACCAA
TCGTGATCAAAAACAGGCT -> CGTGATCAAAAACAGGCTA
TCGTGGTCTGGCGTAGAGT -> CGTGGTCTGGCGTAGAGTT
TCGTTAAAACTTTTTCCCA -> CGTTAAAACTTTTTCCCAG
TCGTTGGGAGTAAACGACT -> CGTTGGGAGTAAACGACTA
TCGTTGTAAATTTCCCGAT -> CGTTGTAAATTTCCCGATC
TCGTTTACAAATCACTAAA -> CGTTTACAAATCACTAAAT
TCTAACGGCGTAGGCCTTA -> CTAACGGCGTAGGCCTTAG
TCTAAGTTACCAAATATTC -> CTAAGTTACCAAATATTCC
TCTACGTGAATAGCTGTTG -> CTACGTGAATAGCTGTTGG
TCTATGTCGTAGGCAGGGG -> CTATGTCGTAGGCAGGGGT
TCTCAAACCCCGGGAAAGG -> CTCAAACCCCGGGAAAGGT
TCTCATTCCTATATCTTGG -> CTCATTCCTATATCTTGGG
TCTCGAACCTTAAGCACCC -> CTCGAACCTTAAGCACCCT
TCTCGCGAGGTTTTTACTG -> CTCGCGAGGTTTTTACTGG
TCTCGGGCTAACCAAACTG -> CTCGGGCTAACCAAACTGT
TCTCGTTGTAAATTTCCCG -> CTCGTTGTAAATTTCCCGA
TCTCTGAGCTCTGATCCGT -> CTCTGAGCTCTGATCCGTT
TCTCTTCTTTGTTGGAACA -> CTCTTCTTTGTTGGAACAG
TCTGAGCTCTGATCCGTTC -> CTGAGCTCTGATCCGTTCG
TCTGATCCGTTCGCTTGAT -> CTGATCCGTTCGCTTGATG
TCTGCACTAGATCTGGCCG -> CTGCACTAGATCTGGCCGG
TCTGGCCGGGCGCCAGTAC -> CTGGCCGGGCGCCAGTACT
TCTGGCCGGGCGCCAGTCG -> CTGGCCGGGCGCCAGTCGT
TCTGGCCGGGCGCCAGTGT -> CTGGCCGGGCGCCAGTGTA
TCTGGCCGGGCGCCAGTTA -> CTGGCCGGGCGCCAGTTAT
TCTGGCGTAGAGTTATACA -> CTGGCGTAGAGTTATACAG
TCTGTAGAAGGCGGTACAA -> CTGTAGAAGGCGGTACAAC
TCTTAGCTAACGTTGCCTA -> CTTAGCTAACGTTGCCTAC
TCTTATTACTAAACGCCGG -> CTTATTACTAAACGCCGGG
TCTTCCGGGCGTCCGAGAG -> CTTCCGGGCGTCCGAGAGG
TCTTCTCATTCCTATATCT -> CTTCTCATTCCTATATCTT
TCTTCTTTGTTGGAACAGG -> CTTCTTTGTTGGAACAGGG
TCTTGAAATATTCCGTTAT -> CTTGAAATATTCCGTTATC
TCTTGCTTGCCCAGGGGCC -> CTTGCTTGCCCAGGGGCCT
TCTTGGGGGGATGACTTTC -> CTTGGGGGGATGACTTTCG
TCTTTACCTAGATACGCTC -> CTTTACCTAGATACGCTCC
TCTTTCCCCTAAGCAGTCT -> CTTTCCCCTAAGCAGTCTC
TCTTTGTTGGAACAGGGCC -> CTTTGTTGGAACAGGGCCC
TGAAACGTCGGGTCCGGAC -> GAAACGTCGGGTCCGGACT
TGAAACTAAAGGGTTGAAG -> GAAACTAAAGGGTTGAAGA
TGAAATATTCCGTTATCAT -> GAAATATTCCGTTATCATC
TGAACACTAAATGCCTGCC -> GAACACTAAATGCCTGCCG
TGAACCGTTTGGATGCTTG -> GAACCGTTTGGATGCTTGC
TGAACTATTGTATGATCGG -> GAACTATTGTATGATCGGG
TGAAGACAGTAAGTCAGTT -> GAAGACAGTAAGTCAGTTC
TGAATAGCTGTTGGCTTGG -> GAATAGCTGTTGGCTTGGT
TGAATTCTCGGGCTAACCA -> GAATTCTCGGGCTAACCAA
TGACCGCTCGTACCGATGG -> GACCGCTCGTACCGATGGG
TGACCTGTCATTGCCTACC -> GACCTGTCATTGCCTACCG
TGACGACGGCTCGGCCGAG -> GACGACGGCTCGGCCGAGG
TGACTGACCTGTCATTGCC -> GACTGACCTGTCATTGCCT
TGACTTTCGGGTAACGAAG -> GACTTTCGGGTAACGAAGG
TGAGATATCGCTTCAAACA -> GAGATATCGCTTCAAACAG
TGAGATGGTAACTCTTAGC -> GAGATGGTAACTCTTAGCT
TGAGCAATTTATGTCCCGA -> GAGCAATTTATGTCCCGAT
TGAGCTCTGATCCGTTCGC -> GAGCTCTGATCCGTTCGCT
TGAGTCCATGATAGGATTC -> GAGTCCATGATAGGATTCT
TGAGTCTTCTCATTCCTAT -> GAGTCTTCTCATTCCTATA
TGATAGGATTCTTCCGGGC -> GATAGGATTCTTCCGGGCG
TGATCAAAAACAGGCTACT -> GATCAAAAACAGGCTACTC
TGATCCGTTCGCTTGATGA -> GATCCGTTCGCTTGATGAC
TGATCGGACTGCCGTGTTA -> GATCGGACTGCCGTGTTAT
TGATCGGGCGGGGGCGGGT -> GATCGGGCGGGGGCGGGTT
TGATGACTGACCTGTCATT -> GATGACTGACCTGTCATTG
TGATGTTTTTCGCCTCTAT -> GATGTTTTTCGCCTCTATG
TGCAAACACGACTCCAAAT -> GCAAACACGACTCCAAATC
TGCAAGGATGCAGCAACAC -> GCAAGGATGCAGCAACACG
TGCACACGGATGAGATATC -> GCACACGGATGAGATATCG
TGCACCAATTGATCGGACT -> GCACCAATTGATCGGACTG
TGCACTAGATCTGGCCGGG -> GCACTAGATCTGGCCGGGC
TGCAGCAACACGAATCTAC -> GCAGCAACACGAATCTACG
TGCAGCTTGCATTCCTGAC -> GCAGCTTGCATTCCTGACC
TGCAGGCTTGCCCCATTAT -> GCAGGCTTGCCCCATTATC
TGCAGGTGGGTTTCGACCA -> GCAGGTGGGTTTCGACCAT
TGCAGTAGATTGGTAGTGC -> GCAGTAGATTGGTAGTGCC
TGCAGTTTGCAGGTGGGTT -> GCAGTTTGCAGGTGGGTTT
TGCATTCCTGACCGCTCGT -> GCATTCCTGACCGCTCGTA
TGCATTTTTTGTCGTTGGG -> GCATTTTTTGTCGTTGGGA
TGCCAATACCACAACTTTT -> GCCAATACCACAACTTTTT
TGCCAGGAGAACCGGTCGT -> GCCAGGAGAACCGGTCGTG
TGCCCAGGGGCCTGGACGC -> GCCCAGGGGCCTGGACGCC
TGCCCCATTATCCACTGCT -> GCCCCATTATCCACTGCTT
TGCCCCATTTCATTGCTGC -> GCCCCATTTCATTGCTGCT
TGCCCGTTCTGTAGAAGGC -> GCCCGTTCTGTAGAAGGCG
TGCCGCGAAATGCCTGCCG -> GCCGCGAAATGCCTGCCGC
TGCCGCGAATTTTCAAGGT -> GCCGCGAATTTTCAAGGTT
TGCCGCGACCAATTGTAAG -> GCCGCGACCAATTGTAAGC
TGCCGCGATAGGTCCTTGC -> GCCGCGATAGGTCCTTGCC
TGCCGGGTTTTTTCGGGCA -> GCCGGGTTTTTTCGGGCAT
TGCCGTGTTATGCAGTAGA -> GCCGTGTTATGCAGTAGAT
TGCCTACCGTGCGCGAGAC -> GCCTACCGTGCGCGAGACC
TGCCTACGACGATCCACTC -> GCCTACGACGATCCACTCG
TGCCTGCCGCGAAATGCCT -> GCCTGCCGCGAAATGCCTG
TGCCTGCCGCGAATTTTCA -> GCCTGCCGCGAATTTTCAA
TGCCTGCCGCGACCAATTG -> GCCTGCCGCGACCAATTGT
TGCCTGCCGCGATAGGTCC -> GCCTGCCGCGATAGGTCCT
TGCCTGTTCCGCCGGATTC -> GCCTGTTCCGCCGGATTCT
TGCCTTACAATACCTCACG -> GCCTTACAATACCTCACGT
TGCCTTGCAAGGATGCAGC -> GCCTTGCAAGGATGCAGCA
TGCGACGGATTGTACCAAC -> GCGACGGATTGTACCAACA
TGCGATAAGCAACTCTTGA -> GCGATAAGCAACTCTTGAA
TGCGCGAGACCGAATTAAT -> GCGCGAGACCGAATTAATC
TGCGTCATTCTCGTTGTAA -> GCGTCATTCTCGTTGTAAA
TGCGTTTGCAGGCTTGCCC -> GCGTTTGCAGGCTTGCCCC
TGCGTTTTGCCGGGTTTTT -> GCGTTTTGCCGGGTTTTTT
TGCTAAATCGGCTGTCCCC -> GCTAAATCGGCTGTCCCCA
TGCTCATCCGATCTCTTCT -> GCTCATCCGATCTCTTCTT
TGCTGATGTTTTTCGCCTC -> GCTGATGTTTTTCGCCTCT
TGCTGCTAAATCGGCTGTC -> GCTGCTAAATCGGCTGTCC
TGCTTAGGTTGCCAGGAGA -> GCTTAGGTTGCCAGGAGAA
TGCTTGCCCAGGGGCCTGG -> GCTTGCCCAGGGGCCTGGA
TGCTTGCGTCATTCTCGTT -> GCTTGCGTCATTCTCGTTG
TGGAACAGGGCCCCGTCAA -> GGAACAGGGCCCCGTCAAA
TGGACGCATAGAACATACC -> GGACGCATAGAACATACCG
TGGACGCCAGGAGGAGCCA -> GGACGCCAGGAGGAGCCAG
TGGACGCCTTTCATCCCTG -> GGACGCCTTTCATCCCTGG
TGGAGCACGGACGTGCCTT -> GGAGCACGGACGTGCCTTG
TGGATGCTTGCGTCATTCT -> GGATGCTTGCGTCATTCTC
TGGATGGTTTACGCGAACC -> GGATGGTTTACGCGAACCG
TGGATGTACCTCAAGACTG -> GGATGTACCTCAAGACTGT
TGGCAGCGATCCCACAAGG -> GGCAGCGATCCCACAAGGT
TGGCATCCACTTAGTGCAG -> GGCATCCACTTAGTGCAGC
TGGCCCTGGGGCTGCACAC -> GGCCCTGGGGCTGCACACG
TGGCCGGGCGCCAGTACTT -> GGCCGGGCGCCAGTACTTT
TGGCCGGGCGCCAGTCGTT -> GGCCGGGCGCCAGTCGTTT
TGGCCGGGCGCCAGTGTAG -> GGCCGGGCGCCAGTGTAGA
TGGCCGGGCGCCAGTTATC -> GGCCGGGCGCCAGTTATCA
TGGCGAGCCCATCACCGGA -> GGCGAGCCCATCACCGGAA
TGGCGCTTTGCCAATACCA -> GGCGCTTTGCCAATACCAC
TGGCGTAGAGTTATACAGT -> GGCGTAGAGTTATACAGTT
TGGCGTGCTGATGTTTTTC -> GGCGTGCTGATGTTTTTCG
TGGCTTGGTTCGCGATAAC -> GGCTTGGTTCGCGATAACT
TGGCTTGTTCAGGTTCCGA -> GGCTTGTTCAGGTTCCGAT
TGGGAGTAAACGACTACCC -> GGGAGTAAACGACTACCCT
TGGGCTTCTAAGTTACCAA -> GGGCTTCTAAGTTACCAAA
TGGGGCTGCACACGGATGA -> GGGGCTGCACACGGATGAG
TGGGGGGATGACTTTCGGG -> GGGGGGATGACTTTCGGGT
TGGGTAGAAAAACATTGTA -> GGGTAGAAAAACATTGTAT
TGGGTCCTTAATCGCACGC -> GGGTCCTTAATCGCACGCG
TGGGTTTCGACCATGGCGC -> GGGTTTCGACCATGGCGCT
TGGTAACTCTTAGCTAACG -> GGTAACTCTTAGCTAACGT
TGGTAGTGCCTTACAATAC -> GGTAGTGCCTTACAATACC
TGGTCGCGATGTTTGTCGT -> GGTCGCGATGTTTGTCGTC
TGGTCTGGCGTAGAGTTAT -> GGTCTGGCGTAGAGTTATA
TGGTGCGATAAGCAACTCT -> GGTGCGATAAGCAACTCTT
TGGTGTTTGCGACGGATTG -> GGTGTTTGCGACGGATTGT
TGGTTCGCGATAACTCGCC -> GGTTCGCGATAACTCGCCG
TGGTTTACGCGAACCGAGA -> GGTTTACGCGAACCGAGAC
TGTAAATTTCCCGATCCCA -> GTAAATTTCCCGATCCCAG
TGTAAGCCCGCTACGAATG -> GTAAGCCCGCTACGAATGA
TGTAATCTGGCCGGGCGCC -> GTAATCTGGCCGGGCGCCA
TGTACCAACACTCCTTGAG -> GTACCAACACTCCTTGAGT
TGTACCTCAAGACTGTGGA -> GTACCTCAAGACTGTGGAG
TGTAGAAGGCGGTACAACA -> GTAGAAGGCGGTACAACAG
TGTAGAAGTACGGGAACCT -> GTAGAAGTACGGGAACCTT
TGTAGACATGAGATGGTAA -> GTAGACATGAGATGGTAAC
TGTAGACTTGAACACTAAA -> GTAGACTTGAACACTAAAT
TGTATGATCGGGCGGGGGC -> GTATGATCGGGCGGGGGCG
TGTATGCTCATCCGATCTC -> GTATGCTCATCCGATCTCT
TGTATTACGTAGGTGAACC -> GTATTACGTAGGTGAACCG
TGTCATTGCCTACCGTGCG -> GTCATTGCCTACCGTGCGC
TGTCCCCACTTTTCCAAAT -> GTCCCCACTTTTCCAAATG
TGTCGTAGGCAGGGGTCGT -> GTCGTAGGCAGGGGTCGTA
TGTCGTCGACCGCTTGCAC -> GTCGTCGACCGCTTGCACC
TGTCGTTGGGAGTAAACGA -> GTCGTTGGGAGTAAACGAC
TGTCTGCACTAGATCTGGC -> GTCTGCACTAGATCTGGCC
TGTGCGTTTGCAGGCTTGC -> GTGCGTTTGCAGGCTTGCC
TGTGGAGCACGGACGTGCC -> GTGGAGCACGGACGTGCCT
TGTGGCTTGTTCAGGTTCC -> GTGGCTTGTTCAGGTTCCG
TGTGTATTACGTAGGTGAA -> GTGTATTACGTAGGTGAAC
TGTTATGCAGTAGATTGGT -> GTTATGCAGTAGATTGGTA
TGTTCAGGTTCCGATTAAC -> GTTCAGGTTCCGATTAACG
TGTTCCGCCGGATTCTCGC -> GTTCCGCCGGATTCTCGCG
TGTTGGAACAGGGCCCCGT -> GTTGGAACAGGGCCCCGTC
TGTTGGCTTGGTTCGCGAT -> GTTGGCTTGGTTCGCGATA
TGTTGGTCGCGATGTTTGT -> GTTGGTCGCGATGTTTGTC
TGTTTGCGACGGATTGTAC -> GTTTGCGACGGATTGTACC
TGTTTGGCCCTGGGGCTGC -> GTTTGGCCCTGGGGCTGCA
TGTTTGTCGTCGACCGCTT -> GTTTGTCGTCGACCGCTTG
TGTTTTTCGCCTCTATGTC -> GTTTTTCGCCTCTATGTCG
TGTTTTTCGTCCCCATAGC -> GTTTTTCGTCCCCATAGCC
TTAAAACTTTTTCCCAGGG -> TAAAACTTTTTCCCAGGGT
TTAACGCCGAAGTACTGTT -> TAACGCCGAAGTACTGTTG
TTAAGAACGGTCCGGGAAT -> TAAGAACGGTCCGGGAATA
TTAAGCACCCTCAGCCCAA -> TAAGCACCCTCAGCCCAAC
TTAATCCCTTTAGCTGAGT -> TAATCCCTTTAGCTGAGTC
TTAATCGCACGCGTAAGGC -> TAATCGCACGCGTAAGGCA
TTACAAATCACTAAATGCC -> TACAAATCACTAAATGCCT
TTACAATACCTCACGTGTG -> TACAATACCTCACGTGTGC
TTACCAAATATTCCACCCT -> TACCAAATATTCCACCCTA
TTACCTAGATACGCTCCAC -> TACCTAGATACGCTCCACT
TTACGATATTCCGGTATAG -> TACGATATTCCGGTATAGT
TTACGCGAACCGAGACTTA -> TACGCGAACCGAGACTTAC
TTACGTAGGTGAACCGTTT -> TACGTAGGTGAACCGTTTG
TTACTAAACGCCGGGACTC -> TACTAAACGCCGGGACTCT
TTACTGGGCTTCTAAGTTA -> TACTGGGCTTCTAAGTTAC
TTAGCTAACGTTGCCTACG -> TAGCTAACGTTGCCTACGA
TTAGCTGAGTCTTCTCATT -> TAGCTGAGTCTTCTCATTC
TTAGGCTTTGCGTTTTGCC -> TAGGCTTTGCGTTTTGCCG
TTAGGGATTGGACGCCTTT -> TAGGGATTGGACGCCTTTC
TTAGGTTGCCAGGAGAACC -> TAGGTTGCCAGGAGAACCG
TTAGTGCAGCTTGCATTCC -> TAGTGCAGCTTGCATTCCT
TTATACAGTTGAAACTAAA -> TATACAGTTGAAACTAAAG
TTATATCAGGCTTTCAAGA -> TATATCAGGCTTTCAAGAC
TTATCACGAGTACACTAAA -> TATCACGAGTACACTAAAT
TTATCATCTGGCCGGGCGC -> TATCATCTGGCCGGGCGCC
TTATCCACTGCTTAGGTTG -> TATCCACTGCTTAGGTTGC
TTATGCAGTAGATTGGTAG -> TATGCAGTAGATTGGTAGT
TTATGGCGTGCTGATGTTT -> TATGGCGTGCTGATGTTTT
TTATTACTAAACGCCGGGA -> TATTACTAAACGCCGGGAC
TTCAAACAGGTGCCCGTTC -> TCAAACAGGTGCCCGTTCT
TTCAAGACTTGGGTCCTTA -> TCAAGACTTGGGTCCTTAA
TTCAAGGTTCCCGTATCTG -> TCAAGGTTCCCGTATCTGG
TTCAATGGATGGTTTACGC -> TCAATGGATGGTTTACGCG
TTCAGGTTCCGATTAACGC -> TCAGGTTCCGATTAACGCC
TTCAGTGCAAACACGACTC -> TCAGTGCAAACACGACTCC
TTCATCCCTGGCAGCGATC -> TCATCCCTGGCAGCGATCC
TTCATTGCTGCTAAATCGG -> TCATTGCTGCTAAATCGGC
TTCCAAATGGATGTACCTC -> TCCAAATGGATGTACCTCA
TTCCACCCTACAGTTTCTA -> TCCACCCTACAGTTTCTAA
TTCCCAGGGTTCGCCAGGT -> TCCCAGGGTTCGCCAGGTG
TTCCCCTAAGCAGTCTCAA -> TCCCCTAAGCAGTCTCAAA
TTCCCGATCCCAGTTAGGG -> TCCCGATCCCAGTTAGGGA
TTCCCGTATCTGGCCGGGC -> TCCCGTATCTGGCCGGGCG
TTCCGATTAACGCCGAAGT -> TCCGATTAACGCCGAAGTA
TTCCGCCGGATTCTCGCGA -> TCCGCCGGATTCTCGCGAG
TTCCGCGAAACAGAAGAGT -> TCCGCGAAACAGAAGAGTT
TTCCGGGCGTCCGAGAGGA -> TCCGGGCGTCCGAGAGGAG
TTCCGGTATAGTCGTACGC -> TCCGGTATAGTCGTACGCA
TTCCGTTATCATCTGGCCG -> TCCGTTATCATCTGGCCGG
TTCCTATATCTTGGGGGGA -> TCCTATATCTTGGGGGGAT
TTCCTCATGCAGTTTGCAG -> TCCTCATGCAGTTTGCAGG
TTCCTCTTTCCCCTAAGCA -> TCCTCTTTCCCCTAAGCAG
TTCCTGACCGCTCGTACCG -> TCCTGACCGCTCGTACCGA
TTCGACCATGGCGCTTTGC -> TCGACCATGGCGCTTTGCC
TTCGCCAGGTGAACTATTG -> TCGCCAGGTGAACTATTGT
TTCGCCTATGCCTGTTCCG -> TCGCCTATGCCTGTTCCGC
TTCGCCTCGTGGTCTGGCG -> TCGCCTCGTGGTCTGGCGT
TTCGCCTCTATGTCGTAGG -> TCGCCTCTATGTCGTAGGC
TTCGCGATAACTCGCCGTG -> TCGCGATAACTCGCCGTGA
TTCGCTTGATGACTGACCT -> TCGCTTGATGACTGACCTG
TTCGGCACTGGCATCCACT -> TCGGCACTGGCATCCACTT
TTCGGGCATTGAAACGTCG -> TCGGGCATTGAAACGTCGG
TTCGGGTAACGAAGGCAAA -> TCGGGTAACGAAGGCAAAT
TTCGTCCCCATAGCCTCAC -> TCGTCCCCATAGCCTCACG
TTCTAACGGCGTAGGCCTT -> TCTAACGGCGTAGGCCTTA
TTCTAAGTTACCAAATATT -> TCTAAGTTACCAAATATTC
TTCTCATTCCTATATCTTG -> TCTCATTCCTATATCTTGG
TTCTCGAACCTTAAGCACC -> TCTCGAACCTTAAGCACCC
TTCTCGCGAGGTTTTTACT -> TCTCGCGAGGTTTTTACTG
TTCTCGGGCTAACCAAACT -> TCTCGGGCTAACCAAACTG
TTCTCGTTGTAAATTTCCC -> TCTCGTTGTAAATTTCCCG
TTCTGTAGAAGGCGGTACA -> TCTGTAGAAGGCGGTACAA
TTCTTATTACTAAACGCCG -> TCTTATTACTAAACGCCGG
TTCTTCCGGGCGTCCGAGA -> TCTTCCGGGCGTCCGAGAG
TTCTTTGTTGGAACAGGGC -> TCTTTGTTGGAACAGGGCC
TTGAAACGTCGGGTCCGGA -> TGAAACGTCGGGTCCGGAC
TTGAAACTAAAGGGTTGAA -> TGAAACTAAAGGGTTGAAG
TTGAAATATTCCGTTATCA -> TGAAATATTCCGTTATCAT
TTGAACACTAAATGCCTGC -> TGAACACTAAATGCCTGCC
TTGAAGACAGTAAGTCAGT -> TGAAGACAGTAAGTCAGTT
TTGAGTCCATGATAGGATT -> TGAGTCCATGATAGGATTC
TTGATCGGACTGCCGTGTT -> TGATCGGACTGCCGTGTTA
TTGATGACTGACCTGTCAT -> TGATGACTGACCTGTCATT
TTGCAAGGATGCAGCAACA -> TGCAAGGATGCAGCAACAC
TTGCACCAATTGATCGGAC -> TGCACCAATTGATCGGACT
TTGCAGGCTTGCCCCATTA -> TGCAGGCTTGCCCCATTAT
TTGCAGGTGGGTTTCGACC -> TGCAGGTGGGTTTCGACCA
TTGCATTCCTGACCGCTCG -> TGCATTCCTGACCGCTCGT
TTGCCAATACCACAACTTT -> TGCCAATACCACAACTTTT
TTGCCAGGAGAACCGGTCG -> TGCCAGGAGAACCGGTCGT
TTGCCCAGGGGCCTGGACG -> TGCCCAGGGGCCTGGACGC
TTGCCCCATTATCCACTGC -> TGCCCCATTATCCACTGCT
TTGCCCCATTTCATTGCTG -> TGCCCCATTTCATTGCTGC
TTGCCGGGTTTTTTCGGGC -> TGCCGGGTTTTTTCGGGCA
TTGCCTACCGTGCGCGAGA -> TGCCTACCGTGCGCGAGAC
TTGCCTACGACGATCCACT -> TGCCTACGACGATCCACTC
TTGCGACGGATTGTACCAA -> TGCGACGGATTGTACCAAC
TTGCGTCATTCTCGTTGTA -> TGCGTCATTCTCGTTGTAA
TTGCGTTTTGCCGGGTTTT -> TGCGTTTTGCCGGGTTTTT
TTGCTGCTAAATCGGCTGT -> TGCTGCTAAATCGGCTGTC
TTGCTTGCCCAGGGGCCTG -> TGCTTGCCCAGGGGCCTGG
TTGGAACAGGGCCCCGTCA -> TGGAACAGGGCCCCGTCAA
TTGGACGCCTTTCATCCCT -> TGGACGCCTTTCATCCCTG
TTGGATGCTTGCGTCATTC -> TGGATGCTTGCGTCATTCT
TTGGCCCTGGGGCTGCACA -> TGGCCCTGGGGCTGCACAC
TTGGCTTGGTTCGCGATAA -> TGGCTTGGTTCGCGATAAC
TTGGGAGTAAACGACTACC -> TGGGAGTAAACGACTACCC
TTGGGGGGATGACTTTCGG -> TGGGGGGATGACTTTCGGG
TTGGGTCCTTAATCGCACG -> TGGGTCCTTAATCGCACGC
TTGGTAGTGCCTTACAATA -> TGGTAGTGCCTTACAATAC
TTGGTCGCGATGTTTGTCG -> TGGTCGCGATGTTTGTCGT
TTGGTGCGATAAGCAACTC -> TGGTGCGATAAGCAACTCT
TTGGTGTTTGCGACGGATT -> TGGTGTTTGCGACGGATTG
TTGGTTCGCGATAACTCGC -> TGGTTCGCGATAACTCGCC
TTGTAAATTTCCCGATCCC -> TGTAAATTTCCCGATCCCA
TTGTAAGCCCGCTACGAAT -> TGTAAGCCCGCTACGAATG
TTGTACCAACACTCCTTGA -> TGTACCAACACTCCTTGAG
TTGTATGATCGGGCGGGGG -> TGTATGATCGGGCGGGGGC
TTGTATGCTCATCCGATCT -> TGTATGCTCATCCGATCTC
TTGTCGTCGACCGCTTGCA -> TGTCGTCGACCGCTTGCAC
TTGTCGTTGGGAGTAAACG -> TGTCGTTGGGAGTAAACGA
TTGTCTGCACTAGATCTGG -> TGTCTGCACTAGATCTGGC
TTGTGGCTTGTTCAGGTTC -> TGTGGCTTGTTCAGGTTCC
TTGTTCAGGTTCCGATTAA -> TGTTCAGGTTCCGATTAAC
TTGTTGGAACAGGGCCCCG -> TGTTGGAACAGGGCCCCGT
TTTACAAATCACTAAATGC -> TTACAAATCACTAAATGCC
TTTACCTAGATACGCTCCA -> TTACCTAGATACGCTCCAC
TTTACGCGAACCGAGACTT -> TTACGCGAACCGAGACTTA
TTTACTGGGCTTCTAAGTT -> TTACTGGGCTTCTAAGTTA
TTTAGCTGAGTCTTCTCAT -> TTAGCTGAGTCTTCTCATT
TTTCAAGACTTGGGTCCTT -> TTCAAGACTTGGGTCCTTA
TTTCAAGGTTCCCGTATCT -> TTCAAGGTTCCCGTATCTG
TTTCAATGGATGGTTTACG -> TTCAATGGATGGTTTACGC
TTTCATCCCTGGCAGCGAT -> TTCATCCCTGGCAGCGATC
TTTCATTGCTGCTAAATCG -> TTCATTGCTGCTAAATCGG
TTTCCAAATGGATGTACCT -> TTCCAAATGGATGTACCTC
TTTCCCAGGGTTCGCCAGG -> TTCCCAGGGTTCGCCAGGT
TTTCCCCTAAGCAGTCTCA -> TTCCCCTAAGCAGTCTCAA
TTTCCCGATCCCAGTTAGG -> TTCCCGATCCCAGTTAGGG
TTTCGACCATGGCGCTTTG -> TTCGACCATGGCGCTTTGC
TTTCGCCTATGCCTGTTCC -> TTCGCCTATGCCTGTTCCG
TTTCGCCTCTATGTCGTAG -> TTCGCCTCTATGTCGTAGG
TTTCGGGCATTGAAACGTC -> TTCGGGCATTGAAACGTCG
TTTCGGGTAACGAAGGCAA -> TTCGGGTAACGAAGGCAAA
TTTCGTCCCCATAGCCTCA -> TTCGTCCCCATAGCCTCAC
TTTCTAACGGCGTAGGCCT -> TTCTAACGGCGTAGGCCTT
TTTGCAGGCTTGCCCCATT -> TTGCAGGCTTGCCCCATTA
TTTGCAGGTGGGTTTCGAC -> TTGCAGGTGGGTTTCGACC
TTTGCCAATACCACAACTT -> TTGCCAATACCACAACTTT
TTTGCCGGGTTTTTTCGGG -> TTGCCGGGTTTTTTCGGGC
TTTGCGACGGATTGTACCA -> TTGCGACGGATTGTACCAA
TTTGCGTTTTGCCGGGTTT -> TTGCGTTTTGCCGGGTTTT
TTTGGATGCTTGCGTCATT -> TTGGATGCTTGCGTCATTC
TTTGGCCCTGGGGCTGCAC -> TTGGCCCTGGGGCTGCACA
TTTGGTGCGATAAGCAACT -> TTGGTGCGATAAGCAACTC
TTTGTCGTCGACCGCTTGC -> TTGTCGTCGACCGCTTGCA
TTTGTCGTTGGGAGTAAAC -> TTGTCGTTGGGAGTAAACG
TTTGTCTGCACTAGATCTG -> TTGTCTGCACTAGATCTGG
TTTGTTGGAACAGGGCCCC -> TTGTTGGAACAGGGCCCCG
TTTTACTGGGCTTCTAAGT -> TTTACTGGGCTTCTAAGTT
TTTTCAAGGTTCCCGTATC -> TTTCAAGGTTCCCGTATCT
TTTTCAATGGATGGTTTAC -> TTTCAATGGATGGTTTACG
TTTTCCAAATGGATGTACC -> TTTCCAAATGGATGTACCT
TTTTCCCAGGGTTCGCCAG -> TTTCCCAGGGTTCGCCAGG
TTTTCGCCTATGCCTGTTC -> TTTCGCCTATGCCTGTTCC
TTTTCGCCTCTATGTCGTA -> TTTCGCCTCTATGTCGTAG
TTTTCGGGCATTGAAACGT -> TTTCGGGCATTGAAACGTC
TTTTCGTCCCCATAGCCTC -> TTTCGTCCCCATAGCCTCA
TTTTGCCGGGTTTTTTCGG -> TTTGCCGGGTTTTTTCGGG
TTTTGTCGTTGGGAGTAAA -> TTTGTCGTTGGGAGTAAAC
TTTTGTCTGCACTAGATCT -> TTTGTCTGCACTAGATCTG
TTTTTACTGGGCTTCTAAG -> TTTTACTGGGCTTCTAAGT
TTTTTCCCAGGGTTCGCCA -> TTTTCCCAGGGTTCGCCAG
TTTTTCGCCTATGCCTGTT -> TTTTCGCCTATGCCTGTTC
TTTTTCGCCTCTATGTCGT -> TTTTCGCCTCTATGTCGTA
TTTTTCGGGCATTGAAACG -> TTTTCGGGCATTGAAACGT
TTTTTCGTCCCCATAGCCT -> TTTTCGTCCCCATAGCCTC
TTTTTGTCGTTGGGAGTAA -> TTTTGTCGTTGGGAGTAAA
TTTTTTCGCCTATGCCTGT -> TTTTTCGCCTATGCCTGTT
TTTTTTCGGGCATTGAAAC -> TTTTTCGGGCATTGAAACG
TTTTTTGTCGTTGGGAGTA -> TTTTTGTCGTTGGGAGTAA